State Code,District Code,Tahsil/ Sub-District Code,Town/ Village Code,Ward Code,Enumeration Block Code,Level,Name,Total/ Rural/ Urban,Total - Persons,Total - Males,Total - Females,Scheduled Caste - Persons,Scheduled Caste - Males,Scheduled Caste - Females,Scheduled Tribe - Persons,Scheduled Tribe - Males,Scheduled Tribe - Females
33,15,0000,00000000,0,0,DISTRICT,Tiruchirappalli,Total,2418366,1208534,1209832,399493,197917,201576,18912,9596,9316
33,15,0000,00000000,0,0,DISTRICT,Tiruchirappalli,Rural,1279204,638617,640587,261417,129181,132236,14383,7324,7059
33,15,0000,00000000,0,0,DISTRICT,Tiruchirappalli,Urban,1139162,569917,569245,138076,68736,69340,4529,2272,2257
33,15,0001,00000000,0,0,TALUK,Thottiyam,Total,126569,63461,63108,26826,13285,13541,68,37,31
33,15,0001,00000000,0,0,TALUK,Thottiyam,Rural,101768,51128,50640,19952,9882,10070,67,36,31
33,15,0001,00000000,0,0,TALUK,Thottiyam,Urban,24801,12333,12468,6874,3403,3471,1,1,0
33,15,0001,00883400,0,0,VILLAGE,Kidaram,Rural,1923,978,945,395,189,206,0,0,0
33,15,0001,00883500,0,0,VILLAGE,Murungai,Rural,2865,1450,1415,711,362,349,0,0,0
33,15,0001,00883600,0,0,VILLAGE,Valveluthur,Rural,638,333,305,233,121,112,0,0,0
33,15,0001,00883700,0,0,VILLAGE,M.Kalathur,Rural,4117,2061,2056,1358,663,695,0,0,0
33,15,0001,00883800,0,0,VILLAGE,Elurpatti,Rural,7174,3624,3550,711,376,335,0,0,0
33,15,0001,00883900,0,0,VILLAGE,Kamalapuram,Rural,4152,2126,2026,200,106,94,0,0,0
33,15,0001,00884000,0,0,VILLAGE,Arangoor,Rural,4341,2225,2116,422,221,201,0,0,0
33,15,0001,00884100,0,0,VILLAGE,Appanallur,Rural,5386,2745,2641,1436,727,709,0,0,0
33,15,0001,00884200,0,0,VILLAGE,Kolakudi,Rural,5074,2558,2516,1402,706,696,0,0,0
33,15,0001,00884300,0,0,VILLAGE,Tholurpatti,Rural,12945,6575,6370,217,98,119,0,0,0
33,15,0001,00884400,0,0,VILLAGE,Nagayanallur,Rural,5554,2755,2799,1649,819,830,0,0,0
33,15,0001,00884500,0,0,VILLAGE,Pidaramangalam,Rural,2213,1100,1113,1075,523,552,0,0,0
33,15,0001,00884600,0,0,VILLAGE,Unniyur,Rural,2299,1142,1157,237,125,112,0,0,0
33,15,0001,00884700,0,0,VILLAGE,Periapallipalayam,Rural,1487,722,765,227,112,115,0,0,0
33,15,0001,00884800,0,0,VILLAGE,Chinnapallipalayam,Rural,1302,649,653,183,92,91,3,2,1
33,15,0001,00884900,0,0,VILLAGE,Sriramasamudram,Rural,3234,1609,1625,1105,548,557,0,0,0
33,15,0001,00885000,0,0,VILLAGE,Kattuputtur ,Rural,1224,595,629,424,200,224,0,0,0
33,15,0001,00885100,0,0,VILLAGE,Seelaipillayarputhur  ,Rural,2266,1136,1130,674,329,345,0,0,0
33,15,0001,00885200,0,0,VILLAGE,Kaduvetti,Rural,3132,1533,1599,311,150,161,0,0,0
33,15,0001,00885300,0,0,VILLAGE,Natham  ,Rural,4118,2040,2078,796,367,429,0,0,0
33,15,0001,00885400,0,0,VILLAGE,M.Puthur  (Musiri),Rural,4505,2305,2200,1050,531,519,0,0,0
33,15,0001,00885500,0,0,VILLAGE,Arasalur ,Rural,3444,1710,1734,984,468,516,0,0,0
33,15,0001,00885600,0,0,VILLAGE,Thirunarayanapuram,Rural,518,254,264,107,47,60,0,0,0
33,15,0001,00885700,0,0,VILLAGE,Srinivasanallur ,Rural,4229,2116,2113,1133,532,601,0,0,0
33,15,0001,00885800,0,0,VILLAGE,Alagarai,Rural,7410,3694,3716,1573,797,776,0,0,0
33,15,0001,00885900,0,0,VILLAGE,Manamedu,Rural,2907,1438,1469,71,34,37,0,0,0
33,15,0001,00886000,0,0,VILLAGE,Mullipadi  ,Rural,3311,1655,1656,1268,639,629,64,34,30
33,15,0001,41501000,0,0,TOWN,Thottiyam (TP),Urban,13683,6806,6877,3901,1928,1973,1,1,0
33,15,0001,41501000,1,0,WARD,Thottiyam (TP) - Ward No.1,Urban,1167,593,574,74,39,35,0,0,0
33,15,0001,41501000,2,0,WARD,Thottiyam (TP) - Ward No.2,Urban,697,342,355,538,260,278,0,0,0
33,15,0001,41501000,3,0,WARD,Thottiyam (TP) - Ward No.3,Urban,1023,518,505,703,358,345,0,0,0
33,15,0001,41501000,4,0,WARD,Thottiyam (TP) - Ward No.4,Urban,1038,518,520,47,22,25,0,0,0
33,15,0001,41501000,5,0,WARD,Thottiyam (TP) - Ward No.5,Urban,961,494,467,54,24,30,0,0,0
33,15,0001,41501000,6,0,WARD,Thottiyam (TP) - Ward No.6,Urban,835,426,409,376,194,182,0,0,0
33,15,0001,41501000,7,0,WARD,Thottiyam (TP) - Ward No.7,Urban,932,453,479,15,9,6,0,0,0
33,15,0001,41501000,8,0,WARD,Thottiyam (TP) - Ward No.8,Urban,733,357,376,30,19,11,0,0,0
33,15,0001,41501000,9,0,WARD,Thottiyam (TP) - Ward No.9,Urban,820,404,416,5,4,1,0,0,0
33,15,0001,41501000,10,0,WARD,Thottiyam (TP) - Ward No.10,Urban,792,381,411,7,4,3,0,0,0
33,15,0001,41501000,11,0,WARD,Thottiyam (TP) - Ward No.11,Urban,1006,494,512,269,127,142,0,0,0
33,15,0001,41501000,12,0,WARD,Thottiyam (TP) - Ward No.12,Urban,902,451,451,896,447,449,0,0,0
33,15,0001,41501000,13,0,WARD,Thottiyam (TP) - Ward No.13,Urban,933,443,490,487,224,263,0,0,0
33,15,0001,41501000,14,0,WARD,Thottiyam (TP) - Ward No.14,Urban,905,463,442,22,10,12,0,0,0
33,15,0001,41501000,15,0,WARD,Thottiyam (TP) - Ward No.15,Urban,939,469,470,378,187,191,1,1,0
33,15,0001,41502000,0,0,TOWN,Kattuputhur (TP),Urban,11118,5527,5591,2973,1475,1498,0,0,0
33,15,0001,41502000,1,0,WARD,Kattuputhur (TP) - Ward No.1,Urban,836,424,412,679,339,340,0,0,0
33,15,0001,41502000,2,0,WARD,Kattuputhur (TP) - Ward No.2,Urban,735,374,361,234,116,118,0,0,0
33,15,0001,41502000,3,0,WARD,Kattuputhur (TP) - Ward No.3,Urban,1398,683,715,459,223,236,0,0,0
33,15,0001,41502000,4,0,WARD,Kattuputhur (TP) - Ward No.4,Urban,949,472,477,0,0,0,0,0,0
33,15,0001,41502000,5,0,WARD,Kattuputhur (TP) - Ward No.5,Urban,1149,561,588,600,292,308,0,0,0
33,15,0001,41502000,6,0,WARD,Kattuputhur (TP) - Ward No.6,Urban,1310,671,639,36,20,16,0,0,0
33,15,0001,41502000,7,0,WARD,Kattuputhur (TP) - Ward No.7,Urban,395,188,207,4,2,2,0,0,0
33,15,0001,41502000,8,0,WARD,Kattuputhur (TP) - Ward No.8,Urban,503,254,249,4,1,3,0,0,0
33,15,0001,41502000,9,0,WARD,Kattuputhur (TP) - Ward No.9,Urban,633,313,320,7,4,3,0,0,0
33,15,0001,41502000,10,0,WARD,Kattuputhur (TP) - Ward No.10,Urban,581,291,290,8,5,3,0,0,0
33,15,0001,41502000,11,0,WARD,Kattuputhur (TP) - Ward No.11,Urban,443,214,229,0,0,0,0,0,0
33,15,0001,41502000,12,0,WARD,Kattuputhur (TP) - Ward No.12,Urban,661,326,335,12,12,0,0,0,0
33,15,0001,41502000,13,0,WARD,Kattuputhur (TP) - Ward No.13,Urban,609,303,306,21,11,10,0,0,0
33,15,0001,41502000,14,0,WARD,Kattuputhur (TP) - Ward No.14,Urban,442,222,220,439,221,218,0,0,0
33,15,0001,41502000,15,0,WARD,Kattuputhur (TP) - Ward No.15,Urban,474,231,243,470,229,241,0,0,0
33,15,0002,00000000,0,0,TALUK,Musiri,Total,221055,110763,110292,43606,21633,21973,421,221,200
33,15,0002,00000000,0,0,TALUK,Musiri,Rural,173278,86940,86338,35829,17736,18093,373,196,177
33,15,0002,00000000,0,0,TALUK,Musiri,Urban,47777,23823,23954,7777,3897,3880,48,25,23
33,15,0002,00886100,0,0,VILLAGE,Pillapalayam,Rural,4437,2257,2180,731,379,352,64,36,28
33,15,0002,00886200,0,0,VILLAGE,Karikali,Rural,3156,1625,1531,605,307,298,0,0,0
33,15,0002,00886300,0,0,VILLAGE,Vadamalaipatti ,Rural,1314,680,634,103,52,51,0,0,0
33,15,0002,00886400,0,0,VILLAGE,Kargudi,Rural,2076,1075,1001,346,169,177,0,0,0
33,15,0002,00886500,0,0,VILLAGE,Urakkarai,Rural,4180,2112,2068,1492,741,751,0,0,0
33,15,0002,00886600,0,0,VILLAGE,Mahadevi,Rural,4661,2321,2340,996,481,515,5,3,2
33,15,0002,00886700,0,0,VILLAGE,Jambumadai,Rural,3442,1745,1697,606,312,294,0,0,0
33,15,0002,00886800,0,0,VILLAGE,Valasiramani,Rural,3181,1662,1519,219,106,113,0,0,0
33,15,0002,00886900,0,0,VILLAGE,Anjalam,Rural,3538,1783,1755,222,109,113,0,0,0
33,15,0002,00887000,0,0,VILLAGE,Konappampatti,Rural,1020,524,496,101,49,52,0,0,0
33,15,0002,00887100,0,0,VILLAGE,Devanur ,Rural,2722,1418,1304,573,294,279,0,0,0
33,15,0002,00887200,0,0,VILLAGE,Arachi,Rural,2053,1010,1043,172,79,93,0,0,0
33,15,0002,00887300,0,0,VILLAGE,Valaiyeduppu,Rural,1843,920,923,754,379,375,0,0,0
33,15,0002,00887400,0,0,VILLAGE,Paithambarai,Rural,2682,1360,1322,292,141,151,0,0,0
33,15,0002,00887500,0,0,VILLAGE,Serugudi,Rural,2084,1035,1049,602,314,288,0,0,0
33,15,0002,00887600,0,0,VILLAGE,Poolancheri,Rural,2866,1483,1383,134,57,77,0,0,0
33,15,0002,00887700,0,0,VILLAGE,Soorampatti ,Rural,1778,879,899,166,75,91,0,0,0
33,15,0002,00887800,0,0,VILLAGE,Mavilipatti ,Rural,1803,893,910,397,200,197,0,0,0
33,15,0002,00887900,0,0,VILLAGE,Mangalam,Rural,3566,1826,1740,309,167,142,0,0,0
33,15,0002,00888000,0,0,VILLAGE,Thulayanatham,Rural,4169,2088,2081,1154,567,587,10,4,6
33,15,0002,00888100,0,0,VILLAGE,Thiruthalaiyur,Rural,3396,1656,1740,2109,1009,1100,0,0,0
33,15,0002,00888200,0,0,VILLAGE,Thuraiyur pudupatti,Rural,4650,2345,2305,387,191,196,0,0,0
33,15,0002,00888300,0,0,VILLAGE,Karattampatti,Rural,2273,1140,1133,254,132,122,22,9,13
33,15,0002,00888400,0,0,VILLAGE,Thinnanur,Rural,2846,1408,1438,432,226,206,0,0,0
33,15,0002,00888500,0,0,VILLAGE,Kottathur,Rural,4877,2340,2537,2241,1081,1160,95,45,50
33,15,0002,00888600,0,0,VILLAGE,Puthanampatti ,Rural,3163,1565,1598,564,268,296,0,0,0
33,15,0002,00888700,0,0,VILLAGE,Abinimangalam,Rural,2438,1175,1263,393,186,207,0,0,0
33,15,0002,00888800,0,0,VILLAGE,Pulivalam ,Rural,4142,2027,2115,902,437,465,0,0,0
33,15,0002,00888900,0,0,VILLAGE,Manparai,Rural,2271,1115,1156,269,131,138,0,0,0
33,15,0002,00889000,0,0,VILLAGE,Sukkampatti,Rural,3427,1714,1713,923,451,472,0,0,0
33,15,0002,00889100,0,0,VILLAGE,Jeyankondam (T.Puthur),Rural,1435,715,720,2,0,2,0,0,0
33,15,0002,00889200,0,0,VILLAGE,Perur,Rural,5218,2687,2531,2281,1170,1111,0,0,0
33,15,0002,00889300,0,0,VILLAGE,Valavandhi East,Rural,1740,885,855,72,35,37,0,0,0
33,15,0002,00889400,0,0,VILLAGE,Valavandhi (West),Rural,2572,1304,1268,257,132,125,0,0,0
33,15,0002,00889500,0,0,VILLAGE,Thumbalam,Rural,3890,1951,1939,559,276,283,0,0,0
33,15,0002,00889600,0,0,VILLAGE,Sittilavai,Rural,2987,1512,1475,860,438,422,0,0,0
33,15,0002,00889700,0,0,VILLAGE,Muthampatti,Rural,1171,591,580,187,101,86,0,0,0
33,15,0002,00889800,0,0,VILLAGE,M.Pudupatti West,Rural,5087,2503,2584,1085,537,548,7,3,4
33,15,0002,00889900,0,0,VILLAGE,M.Pudupatti East,Rural,2799,1468,1331,371,223,148,2,2,0
33,15,0002,00890000,0,0,VILLAGE,Kamatchipatti,Rural,787,379,408,70,36,34,0,0,0
33,15,0002,00890100,0,0,VILLAGE,T.Puthur,Rural,4477,2269,2208,1394,710,684,18,11,7
33,15,0002,00890200,0,0,VILLAGE,Thiruthiamalai,Rural,3263,1631,1632,245,126,119,0,0,0
33,15,0002,00890300,0,0,VILLAGE,Vengaimandalam,Rural,2857,1413,1444,113,56,57,0,0,0
33,15,0002,00890400,0,0,VILLAGE,Moovanur,Rural,1602,836,766,125,59,66,149,82,67
33,15,0002,00890500,0,0,VILLAGE,Peramangalam,Rural,3315,1678,1637,398,206,192,1,1,0
33,15,0002,00890600,0,0,VILLAGE,Kattukulam,Rural,1951,974,977,228,111,117,0,0,0
33,15,0002,00890700,0,0,VILLAGE,Komangalam,Rural,3063,1547,1516,203,95,108,0,0,0
33,15,0002,00890800,0,0,VILLAGE,Neiveli,Rural,2764,1398,1366,272,135,137,0,0,0
33,15,0002,00890900,0,0,VILLAGE,Thinnakonam,Rural,3633,1826,1807,329,171,158,0,0,0
33,15,0002,00891000,0,0,VILLAGE,Mooveli I,Rural,707,348,359,94,45,49,0,0,0
33,15,0002,00891100,0,0,VILLAGE,Savanthilingapuram,Rural,2129,1068,1061,978,483,495,0,0,0
33,15,0002,00891200,0,0,VILLAGE,Umaiyalpuram,Rural,826,413,413,378,186,192,0,0,0
33,15,0002,00891300,0,0,VILLAGE,Vellur,Rural,3801,1876,1925,535,266,269,0,0,0
33,15,0002,00891400,0,0,VILLAGE,Ayyampalayam,Rural,5071,2512,2559,1652,810,842,0,0,0
33,15,0002,00891500,0,0,VILLAGE,Evur,Rural,4163,2070,2093,774,360,414,0,0,0
33,15,0002,00891600,0,0,VILLAGE,Kodunthurai,Rural,3131,1554,1577,1161,550,611,0,0,0
33,15,0002,00891700,0,0,VILLAGE,Sithambur,Rural,2559,1262,1297,644,312,332,0,0,0
33,15,0002,00891800,0,0,VILLAGE,Amoor,Rural,3520,1754,1766,1377,653,724,0,0,0
33,15,0002,00891900,0,0,VILLAGE,Gunaseelam,Rural,2706,1335,1371,737,364,373,0,0,0
33,15,0002,41503000,0,0,TOWN,Mettupalayam (TP),Urban,7550,3774,3776,1106,571,535,0,0,0
33,15,0002,41503000,1,0,WARD,Mettupalayam (TP) - Ward No.1,Urban,599,301,298,0,0,0,0,0,0
33,15,0002,41503000,2,0,WARD,Mettupalayam (TP) - Ward No.2,Urban,700,346,354,7,4,3,0,0,0
33,15,0002,41503000,3,0,WARD,Mettupalayam (TP) - Ward No.3,Urban,688,341,347,14,8,6,0,0,0
33,15,0002,41503000,4,0,WARD,Mettupalayam (TP) - Ward No.4,Urban,445,219,226,7,3,4,0,0,0
33,15,0002,41503000,5,0,WARD,Mettupalayam (TP) - Ward No.5,Urban,383,189,194,0,0,0,0,0,0
33,15,0002,41503000,6,0,WARD,Mettupalayam (TP) - Ward No.6,Urban,314,159,155,0,0,0,0,0,0
33,15,0002,41503000,7,0,WARD,Mettupalayam (TP) - Ward No.7,Urban,600,282,318,4,1,3,0,0,0
33,15,0002,41503000,8,0,WARD,Mettupalayam (TP) - Ward No.8,Urban,396,205,191,0,0,0,0,0,0
33,15,0002,41503000,9,0,WARD,Mettupalayam (TP) - Ward No.9,Urban,415,214,201,11,2,9,0,0,0
33,15,0002,41503000,10,0,WARD,Mettupalayam (TP) - Ward No.10,Urban,472,249,223,472,249,223,0,0,0
33,15,0002,41503000,11,0,WARD,Mettupalayam (TP) - Ward No.11,Urban,431,208,223,0,0,0,0,0,0
33,15,0002,41503000,12,0,WARD,Mettupalayam (TP) - Ward No.12,Urban,590,304,286,590,304,286,0,0,0
33,15,0002,41503000,13,0,WARD,Mettupalayam (TP) - Ward No.13,Urban,621,313,308,0,0,0,0,0,0
33,15,0002,41503000,14,0,WARD,Mettupalayam (TP) - Ward No.14,Urban,426,209,217,1,0,1,0,0,0
33,15,0002,41503000,15,0,WARD,Mettupalayam (TP) - Ward No.15,Urban,470,235,235,0,0,0,0,0,0
33,15,0002,41504000,0,0,TOWN,Thathaiyangarpet (TP),Urban,12286,6221,6065,2814,1428,1386,0,0,0
33,15,0002,41504000,1,0,WARD,Thathaiyangarpet (TP) - Ward No.1,Urban,947,510,437,536,279,257,0,0,0
33,15,0002,41504000,2,0,WARD,Thathaiyangarpet (TP) - Ward No.2,Urban,951,479,472,218,125,93,0,0,0
33,15,0002,41504000,3,0,WARD,Thathaiyangarpet (TP) - Ward No.3,Urban,929,467,462,38,17,21,0,0,0
33,15,0002,41504000,4,0,WARD,Thathaiyangarpet (TP) - Ward No.4,Urban,738,373,365,0,0,0,0,0,0
33,15,0002,41504000,5,0,WARD,Thathaiyangarpet (TP) - Ward No.5,Urban,846,417,429,346,172,174,0,0,0
33,15,0002,41504000,6,0,WARD,Thathaiyangarpet (TP) - Ward No.6,Urban,623,315,308,11,5,6,0,0,0
33,15,0002,41504000,7,0,WARD,Thathaiyangarpet (TP) - Ward No.7,Urban,449,226,223,0,0,0,0,0,0
33,15,0002,41504000,8,0,WARD,Thathaiyangarpet (TP) - Ward No.8,Urban,785,401,384,204,100,104,0,0,0
33,15,0002,41504000,9,0,WARD,Thathaiyangarpet (TP) - Ward No.9,Urban,549,273,276,3,2,1,0,0,0
33,15,0002,41504000,10,0,WARD,Thathaiyangarpet (TP) - Ward No.10,Urban,768,383,385,0,0,0,0,0,0
33,15,0002,41504000,11,0,WARD,Thathaiyangarpet (TP) - Ward No.11,Urban,802,427,375,47,46,1,0,0,0
33,15,0002,41504000,12,0,WARD,Thathaiyangarpet (TP) - Ward No.12,Urban,1009,490,519,1007,490,517,0,0,0
33,15,0002,41504000,13,0,WARD,Thathaiyangarpet (TP) - Ward No.13,Urban,774,393,381,32,16,16,0,0,0
33,15,0002,41504000,14,0,WARD,Thathaiyangarpet (TP) - Ward No.14,Urban,1305,670,635,165,79,86,0,0,0
33,15,0002,41504000,15,0,WARD,Thathaiyangarpet (TP) - Ward No.15,Urban,811,397,414,207,97,110,0,0,0
33,15,0002,41505000,0,0,TOWN,Musiri (TP),Urban,27941,13828,14113,3857,1898,1959,48,25,23
33,15,0002,41505000,1,0,WARD,Musiri (TP) - Ward No.1,Urban,1015,521,494,6,3,3,0,0,0
33,15,0002,41505000,2,0,WARD,Musiri (TP) - Ward No.2,Urban,1788,869,919,19,8,11,7,5,2
33,15,0002,41505000,3,0,WARD,Musiri (TP) - Ward No.3,Urban,1133,592,541,117,62,55,0,0,0
33,15,0002,41505000,4,0,WARD,Musiri (TP) - Ward No.4,Urban,2144,1069,1075,885,437,448,0,0,0
33,15,0002,41505000,5,0,WARD,Musiri (TP) - Ward No.5,Urban,733,363,370,0,0,0,0,0,0
33,15,0002,41505000,6,0,WARD,Musiri (TP) - Ward No.6,Urban,1357,668,689,239,120,119,5,2,3
33,15,0002,41505000,7,0,WARD,Musiri (TP) - Ward No.7,Urban,1971,980,991,294,146,148,5,2,3
33,15,0002,41505000,8,0,WARD,Musiri (TP) - Ward No.8,Urban,1904,933,971,393,202,191,4,2,2
33,15,0002,41505000,9,0,WARD,Musiri (TP) - Ward No.9,Urban,3520,1793,1727,525,281,244,8,4,4
33,15,0002,41505000,10,0,WARD,Musiri (TP) - Ward No.10,Urban,1369,669,700,98,44,54,0,0,0
33,15,0002,41505000,11,0,WARD,Musiri (TP) - Ward No.11,Urban,1596,816,780,107,52,55,0,0,0
33,15,0002,41505000,12,0,WARD,Musiri (TP) - Ward No.12,Urban,1673,686,987,259,71,188,11,6,5
33,15,0002,41505000,13,0,WARD,Musiri (TP) - Ward No.13,Urban,1515,741,774,140,73,67,0,0,0
33,15,0002,41505000,14,0,WARD,Musiri (TP) - Ward No.14,Urban,1676,835,841,97,47,50,0,0,0
33,15,0002,41505000,15,0,WARD,Musiri (TP) - Ward No.15,Urban,1202,558,644,512,227,285,0,0,0
33,15,0002,41505000,16,0,WARD,Musiri (TP) - Ward No.16,Urban,1231,690,541,143,112,31,8,4,4
33,15,0002,41505000,17,0,WARD,Musiri (TP) - Ward No.17,Urban,1075,539,536,17,10,7,0,0,0
33,15,0002,41505000,18,0,WARD,Musiri (TP) - Ward No.18,Urban,1039,506,533,6,3,3,0,0,0
33,15,0003,00000000,0,0,TALUK,Thuraiyur,Total,231497,115588,115909,49589,24572,25017,13218,6730,6488
33,15,0003,00000000,0,0,TALUK,Thuraiyur,Rural,185211,92441,92770,41076,20422,20654,12519,6360,6159
33,15,0003,00000000,0,0,TALUK,Thuraiyur,Urban,46286,23147,23139,8513,4150,4363,699,370,329
33,15,0003,00892000,0,0,VILLAGE,Talugai,Rural,7649,3917,3732,833,443,390,308,175,133
33,15,0003,00892900,0,0,VILLAGE,Koppamapuri  ,Rural,3570,1780,1790,1389,680,709,9,4,5
33,15,0003,00893000,0,0,VILLAGE,Koppampatti ,Rural,6123,3090,3033,773,405,368,70,34,36
33,15,0003,00893200,0,0,VILLAGE,Sukkalampatti Kombai,Rural,413,204,209,2,0,2,252,126,126
33,15,0003,00893300,0,0,VILLAGE,Sengampatti kombai Bit I,Rural,4,2,2,0,0,0,0,0,0
33,15,0003,00893400,0,0,VILLAGE,Sengampatti kombai Bit II,Rural,11,6,5,0,0,0,0,0,0
33,15,0003,00893500,0,0,VILLAGE,Pasari kombai,Rural,532,270,262,27,14,13,393,201,192
33,15,0003,00893600,0,0,VILLAGE,Vairichettipalayam,Rural,6479,3284,3195,1414,721,693,90,45,45
33,15,0003,00893700,0,0,VILLAGE,Karapudaiyampatti,Rural,44,23,21,12,6,6,0,0,0
33,15,0003,00893800,0,0,VILLAGE,Sobanapuram,Rural,6271,3158,3113,1316,667,649,670,352,318
33,15,0003,00893900,0,0,VILLAGE,Osarapalli,Rural,768,376,392,283,136,147,0,0,0
33,15,0003,00894200,0,0,VILLAGE,Thenparanadu ,Rural,3478,1782,1696,26,24,2,3083,1568,1515
33,15,0003,00894500,0,0,VILLAGE,Vannadu ,Rural,3979,2026,1953,1,0,1,3638,1852,1786
33,15,0003,00895300,0,0,VILLAGE,Venkatachalapuram,Rural,3940,1950,1990,486,239,247,5,1,4
33,15,0003,00895400,0,0,VILLAGE,Uppiliapuram  South,Rural,2581,1277,1304,1337,661,676,14,8,6
33,15,0003,00895600,0,0,VILLAGE,Koittapalayam (West),Rural,6549,3100,3449,2418,1149,1269,30,15,15
33,15,0003,00895700,0,0,VILLAGE,Puliyansolaikombai,Rural,59,29,30,0,0,0,0,0,0
33,15,0003,00895900,0,0,VILLAGE,Rudrakshakombai,Rural,638,314,324,0,0,0,20,9,11
33,15,0003,00896000,0,0,VILLAGE,Pachaperumalpatti North,Rural,1366,713,653,248,134,114,12,6,6
33,15,0003,00896100,0,0,VILLAGE,Alathudaiyanpatti,Rural,4521,2238,2283,2146,1042,1104,6,2,4
33,15,0003,00896200,0,0,VILLAGE,Sirunavalur,Rural,4287,2150,2137,2495,1251,1244,101,61,40
33,15,0003,00896300,0,0,VILLAGE,Baderpettai,Rural,3318,1642,1676,543,277,266,0,0,0
33,15,0003,00896400,0,0,VILLAGE,Okkarai,Rural,3601,1756,1845,1005,493,512,82,43,39
33,15,0003,00896500,0,0,VILLAGE,Sikkathambur North,Rural,2683,1340,1343,226,115,111,28,12,16
33,15,0003,00896600,0,0,VILLAGE,Siruganatham,Rural,2755,1362,1393,422,208,214,12,0,12
33,15,0003,00896700,0,0,VILLAGE,T. Renganathapuram  ,Rural,4943,2500,2443,829,413,416,0,0,0
33,15,0003,00896800,0,0,VILLAGE,Maruvathur ,Rural,5456,2723,2733,1079,553,526,49,28,21
33,15,0003,00896900,0,0,VILLAGE,Vengadathanur,Rural,1834,923,911,209,109,100,33,14,19
33,15,0003,00897000,0,0,VILLAGE,Sengattupatti,Rural,5617,2756,2861,1358,691,667,246,120,126
33,15,0003,00897100,0,0,VILLAGE,Kombai,Rural,1932,972,960,0,0,0,1850,932,918
33,15,0003,00897400,0,0,VILLAGE,Keerambur,Rural,6412,3164,3248,1560,742,818,182,88,94
33,15,0003,00897500,0,0,VILLAGE,Murugur  ,Rural,4882,2459,2423,1241,624,617,175,90,85
33,15,0003,00897600,0,0,VILLAGE,Kottaiyur,Rural,2684,1312,1372,377,166,211,17,7,10
33,15,0003,00897700,0,0,VILLAGE,Sikkathambur  South,Rural,3895,1860,2035,1669,824,845,205,92,113
33,15,0003,00897800,0,0,VILLAGE,Kamachipuram,Rural,747,375,372,0,0,0,0,0,0
33,15,0003,00897900,0,0,VILLAGE,Eragudi South,Rural,4970,2480,2490,852,415,437,17,7,10
33,15,0003,00898000,0,0,VILLAGE,Eragudi North,Rural,1436,681,755,461,220,241,0,0,0
33,15,0003,00898100,0,0,VILLAGE,Pachaperumal patti South,Rural,5609,2807,2802,1864,925,939,37,17,20
33,15,0003,00898200,0,0,VILLAGE,Alagapuri ,Rural,3491,1708,1783,733,368,365,13,7,6
33,15,0003,00898300,0,0,VILLAGE,Visalakshiammal Samudram,Rural,1995,974,1021,617,290,327,0,0,0
33,15,0003,00898400,0,0,VILLAGE,Senappanallur,Rural,1397,687,710,373,175,198,0,0,0
33,15,0003,00898500,0,0,VILLAGE,Kalingamudayanpatti,Rural,2044,986,1058,64,35,29,0,0,0
33,15,0003,00898600,0,0,VILLAGE,Venkatesapuram ,Rural,6013,3053,2960,1324,671,653,453,232,221
33,15,0003,00898700,0,0,VILLAGE,Thuraiyur ,Rural,1012,535,477,100,56,44,27,15,12
33,15,0003,00898900,0,0,VILLAGE,Nagalapuram ,Rural,5099,2550,2549,1037,526,511,8,5,3
33,15,0003,00899000,0,0,VILLAGE,Muthiampalayam ,Rural,4026,2044,1982,668,336,332,193,96,97
33,15,0003,00899100,0,0,VILLAGE,Ammapatti,Rural,1332,692,640,112,58,54,0,0,0
33,15,0003,00899200,0,0,VILLAGE,Singalandapuram,Rural,4577,2318,2259,1768,900,868,99,50,49
33,15,0003,00899300,0,0,VILLAGE,Kollapatti,Rural,1529,767,762,0,0,0,0,0,0
33,15,0003,00899400,0,0,VILLAGE,Chokkanathapuram,Rural,1203,585,618,54,23,31,0,0,0
33,15,0003,00899500,0,0,VILLAGE,Veeramachanpatti ,Rural,4297,2133,2164,1071,513,558,0,0,0
33,15,0003,00899600,0,0,VILLAGE,Poonnusangampatti ,Rural,3055,1509,1546,277,135,142,0,0,0
33,15,0003,00899700,0,0,VILLAGE,Kannanur ,Rural,7089,3593,3496,2256,1126,1130,91,45,46
33,15,0003,00899800,0,0,VILLAGE,Vadakkuveli,Rural,3132,1556,1576,620,308,312,0,0,0
33,15,0003,00899900,0,0,VILLAGE,Adanur,Rural,1904,971,933,479,236,243,0,0,0
33,15,0003,00900000,0,0,VILLAGE,Pagalavadi,Rural,4106,2052,2054,323,165,158,1,1,0
33,15,0003,00900200,0,0,VILLAGE,Naduvalur ,Rural,1874,927,947,299,154,145,0,0,0
33,15,0003,41506000,0,0,TOWN,Uppiliapuram (TP),Urban,6699,3368,3331,1366,684,682,24,14,10
33,15,0003,41506000,1,0,WARD,Uppiliapuram (TP) - Ward No.1,Urban,422,236,186,11,11,0,13,8,5
33,15,0003,41506000,2,0,WARD,Uppiliapuram (TP) - Ward No.2,Urban,729,351,378,18,6,12,0,0,0
33,15,0003,41506000,3,0,WARD,Uppiliapuram (TP) - Ward No.3,Urban,694,353,341,1,1,0,0,0,0
33,15,0003,41506000,4,0,WARD,Uppiliapuram (TP) - Ward No.4,Urban,480,238,242,0,0,0,0,0,0
33,15,0003,41506000,5,0,WARD,Uppiliapuram (TP) - Ward No.5,Urban,700,352,348,19,10,9,0,0,0
33,15,0003,41506000,6,0,WARD,Uppiliapuram (TP) - Ward No.6,Urban,503,245,258,483,234,249,0,0,0
33,15,0003,41506000,7,0,WARD,Uppiliapuram (TP) - Ward No.7,Urban,291,142,149,0,0,0,0,0,0
33,15,0003,41506000,8,0,WARD,Uppiliapuram (TP) - Ward No.8,Urban,307,155,152,0,0,0,0,0,0
33,15,0003,41506000,9,0,WARD,Uppiliapuram (TP) - Ward No.9,Urban,381,192,189,0,0,0,11,6,5
33,15,0003,41506000,10,0,WARD,Uppiliapuram (TP) - Ward No.10,Urban,227,107,120,0,0,0,0,0,0
33,15,0003,41506000,11,0,WARD,Uppiliapuram (TP) - Ward No.11,Urban,322,163,159,0,0,0,0,0,0
33,15,0003,41506000,12,0,WARD,Uppiliapuram (TP) - Ward No.12,Urban,290,149,141,279,146,133,0,0,0
33,15,0003,41506000,13,0,WARD,Uppiliapuram (TP) - Ward No.13,Urban,530,264,266,530,264,266,0,0,0
33,15,0003,41506000,14,0,WARD,Uppiliapuram (TP) - Ward No.14,Urban,266,136,130,25,12,13,0,0,0
33,15,0003,41506000,15,0,WARD,Uppiliapuram (TP) - Ward No.15,Urban,557,285,272,0,0,0,0,0,0
33,15,0003,41507000,0,0,TOWN,Balakrishnampatti (TP),Urban,8582,4249,4333,1972,967,1005,228,123,105
33,15,0003,41507000,1,0,WARD,Balakrishnampatti (TP) - Ward No.1,Urban,468,230,238,468,230,238,0,0,0
33,15,0003,41507000,2,0,WARD,Balakrishnampatti (TP) - Ward No.2,Urban,546,256,290,536,250,286,0,0,0
33,15,0003,41507000,3,0,WARD,Balakrishnampatti (TP) - Ward No.3,Urban,447,214,233,0,0,0,0,0,0
33,15,0003,41507000,4,0,WARD,Balakrishnampatti (TP) - Ward No.4,Urban,653,313,340,0,0,0,0,0,0
33,15,0003,41507000,5,0,WARD,Balakrishnampatti (TP) - Ward No.5,Urban,422,211,211,0,0,0,0,0,0
33,15,0003,41507000,6,0,WARD,Balakrishnampatti (TP) - Ward No.6,Urban,341,170,171,322,159,163,0,0,0
33,15,0003,41507000,7,0,WARD,Balakrishnampatti (TP) - Ward No.7,Urban,632,307,325,431,211,220,0,0,0
33,15,0003,41507000,8,0,WARD,Balakrishnampatti (TP) - Ward No.8,Urban,826,424,402,2,1,1,0,0,0
33,15,0003,41507000,9,0,WARD,Balakrishnampatti (TP) - Ward No.9,Urban,693,347,346,0,0,0,0,0,0
33,15,0003,41507000,10,0,WARD,Balakrishnampatti (TP) - Ward No.10,Urban,628,308,320,0,0,0,0,0,0
33,15,0003,41507000,11,0,WARD,Balakrishnampatti (TP) - Ward No.11,Urban,490,235,255,0,0,0,0,0,0
33,15,0003,41507000,12,0,WARD,Balakrishnampatti (TP) - Ward No.12,Urban,776,391,385,0,0,0,0,0,0
33,15,0003,41507000,13,0,WARD,Balakrishnampatti (TP) - Ward No.13,Urban,689,350,339,0,0,0,224,121,103
33,15,0003,41507000,14,0,WARD,Balakrishnampatti (TP) - Ward No.14,Urban,429,210,219,0,0,0,4,2,2
33,15,0003,41507000,15,0,WARD,Balakrishnampatti (TP) - Ward No.15,Urban,542,283,259,213,116,97,0,0,0
33,15,0003,41508000,0,0,TOWN,Thuraiyur (M),Urban,31005,15530,15475,5175,2499,2676,447,233,214
33,15,0003,41508000,1,0,WARD,Thuraiyur (M) - Ward No.1,Urban,1101,544,557,169,81,88,9,3,6
33,15,0003,41508000,2,0,WARD,Thuraiyur (M) - Ward No.2,Urban,1274,642,632,21,7,14,12,6,6
33,15,0003,41508000,3,0,WARD,Thuraiyur (M) - Ward No.3,Urban,946,491,455,8,4,4,84,47,37
33,15,0003,41508000,4,0,WARD,Thuraiyur (M) - Ward No.4,Urban,1143,594,549,8,5,3,5,3,2
33,15,0003,41508000,5,0,WARD,Thuraiyur (M) - Ward No.5,Urban,1248,631,617,0,0,0,0,0,0
33,15,0003,41508000,6,0,WARD,Thuraiyur (M) - Ward No.6,Urban,1183,599,584,3,2,1,0,0,0
33,15,0003,41508000,7,0,WARD,Thuraiyur (M) - Ward No.7,Urban,1807,892,915,38,22,16,0,0,0
33,15,0003,41508000,8,0,WARD,Thuraiyur (M) - Ward No.8,Urban,1051,491,560,0,0,0,5,3,2
33,15,0003,41508000,9,0,WARD,Thuraiyur (M) - Ward No.9,Urban,1811,925,886,189,95,94,27,10,17
33,15,0003,41508000,10,0,WARD,Thuraiyur (M) - Ward No.10,Urban,1458,734,724,0,0,0,9,3,6
33,15,0003,41508000,11,0,WARD,Thuraiyur (M) - Ward No.11,Urban,1435,704,731,18,10,8,0,0,0
33,15,0003,41508000,12,0,WARD,Thuraiyur (M) - Ward No.12,Urban,902,459,443,0,0,0,7,2,5
33,15,0003,41508000,13,0,WARD,Thuraiyur (M) - Ward No.13,Urban,870,430,440,11,7,4,7,5,2
33,15,0003,41508000,14,0,WARD,Thuraiyur (M) - Ward No.14,Urban,1098,533,565,0,0,0,4,2,2
33,15,0003,41508000,15,0,WARD,Thuraiyur (M) - Ward No.15,Urban,1167,589,578,23,11,12,0,0,0
33,15,0003,41508000,16,0,WARD,Thuraiyur (M) - Ward No.16,Urban,1013,499,514,184,91,93,13,7,6
33,15,0003,41508000,17,0,WARD,Thuraiyur (M) - Ward No.17,Urban,1098,525,573,693,330,363,0,0,0
33,15,0003,41508000,18,0,WARD,Thuraiyur (M) - Ward No.18,Urban,2343,1098,1245,2085,966,1119,11,6,5
33,15,0003,41508000,19,0,WARD,Thuraiyur (M) - Ward No.19,Urban,1279,604,675,655,310,345,56,5,51
33,15,0003,41508000,20,0,WARD,Thuraiyur (M) - Ward No.20,Urban,1481,747,734,790,391,399,9,6,3
33,15,0003,41508000,21,0,WARD,Thuraiyur (M) - Ward No.21,Urban,2022,1040,982,90,41,49,21,9,12
33,15,0003,41508000,22,0,WARD,Thuraiyur (M) - Ward No.22,Urban,635,329,306,2,0,2,13,7,6
33,15,0003,41508000,23,0,WARD,Thuraiyur (M) - Ward No.23,Urban,1312,763,549,129,99,30,75,67,8
33,15,0003,41508000,24,0,WARD,Thuraiyur (M) - Ward No.24,Urban,1328,667,661,59,27,32,80,42,38
33,15,0004,00000000,0,0,TALUK,Manachanallur,Total,159013,78944,80069,29775,14614,15161,248,124,124
33,15,0004,00000000,0,0,TALUK,Manachanallur,Rural,125720,62490,63230,24237,11921,12316,229,117,112
33,15,0004,00000000,0,0,TALUK,Manachanallur,Urban,33293,16454,16839,5538,2693,2845,19,7,12
33,15,0004,00900300,0,0,VILLAGE,Perakambi,Rural,2504,1165,1339,1226,577,649,0,0,0
33,15,0004,00900400,0,0,VILLAGE,Seedevimangalam (North),Rural,380,185,195,0,0,0,0,0,0
33,15,0004,00900500,0,0,VILLAGE,Seedevimangalam (South)  ,Rural,743,368,375,176,93,83,0,0,0
33,15,0004,00900600,0,0,VILLAGE,Shanamangalam  ,Rural,3601,1849,1752,1048,556,492,0,0,0
33,15,0004,00900700,0,0,VILLAGE,Vazhaiyur,Rural,1548,795,753,595,313,282,7,5,2
33,15,0004,00900800,0,0,VILLAGE,Edumalai ,Rural,3621,1768,1853,521,258,263,0,0,0
33,15,0004,00900900,0,0,VILLAGE,Omandhur  ,Rural,1965,941,1024,355,154,201,0,0,0
33,15,0004,00901000,0,0,VILLAGE,Sirugudi   ,Rural,1385,657,728,145,63,82,0,0,0
33,15,0004,00901100,0,0,VILLAGE,Valaiyur  ,Rural,3495,1710,1785,294,133,161,0,0,0
33,15,0004,00901200,0,0,VILLAGE,Palaiyur,Rural,1938,995,943,723,358,365,0,0,0
33,15,0004,00901300,0,0,VILLAGE,Thiruppattur,Rural,2535,1277,1258,248,129,119,0,0,0
33,15,0004,00901400,0,0,VILLAGE,Siruganur,Rural,3882,2148,1734,1440,749,691,16,10,6
33,15,0004,00901500,0,0,VILLAGE,Konalai,Rural,3191,1547,1644,214,101,113,0,0,0
33,15,0004,00901700,0,0,VILLAGE,Kariyamanickam,Rural,2144,1064,1080,541,255,286,0,0,0
33,15,0004,00901800,0,0,VILLAGE,Thathamangalam,Rural,2902,1416,1486,394,181,213,0,0,0
33,15,0004,00901900,0,0,VILLAGE,Siruppathur,Rural,2089,1061,1028,114,58,56,108,54,54
33,15,0004,00902000,0,0,VILLAGE,Thiruvallarai,Rural,4310,2222,2088,555,286,269,15,5,10
33,15,0004,00902100,0,0,VILLAGE,Ayyampalayam,Rural,6292,3142,3150,106,54,52,0,0,0
33,15,0004,00902200,0,0,VILLAGE,Ayikudi,Rural,2355,1175,1180,740,377,363,0,0,0
33,15,0004,00902300,0,0,VILLAGE,Irungalur,Rural,6971,3373,3598,910,428,482,0,0,0
33,15,0004,00902400,0,0,VILLAGE,Samayapuram,Rural,3300,1620,1680,608,297,311,0,0,0
33,15,0004,00902500,0,0,VILLAGE,Kalpalayam,Rural,3933,1893,2040,398,184,214,0,0,0
33,15,0004,00902600,0,0,VILLAGE,Rajampalayam,Rural,185,90,95,0,0,0,0,0,0
33,15,0004,00902700,0,0,VILLAGE,Poonampalayam,Rural,4518,2245,2273,443,218,225,0,0,0
33,15,0004,00902800,0,0,VILLAGE,Theerampalayam,Rural,3491,1749,1742,169,87,82,0,0,0
33,15,0004,00902900,0,0,VILLAGE,Thiruppangali (North),Rural,5195,2559,2636,324,155,169,0,0,0
33,15,0004,00903000,0,0,VILLAGE,Thiruppangali (South),Rural,3260,1631,1629,91,52,39,0,0,0
33,15,0004,00903100,0,0,VILLAGE,Solanganallur,Rural,3310,1679,1631,384,203,181,4,3,1
33,15,0004,00903200,0,0,VILLAGE,Kariyamanickam (West),Rural,2939,1428,1511,665,323,342,0,0,0
33,15,0004,00903300,0,0,VILLAGE,Kariyamanickam (East) ,Rural,4025,1996,2029,607,284,323,0,0,0
33,15,0004,00903400,0,0,VILLAGE,Killiyanallur (North),Rural,2007,996,1011,858,425,433,0,0,0
33,15,0004,00903500,0,0,VILLAGE,Killiyanallur (South) ,Rural,1460,732,728,690,347,343,0,0,0
33,15,0004,00903600,0,0,VILLAGE,Melpathu,Rural,3003,1485,1518,823,409,414,0,0,0
33,15,0004,00903700,0,0,VILLAGE,Thiruvasi,Rural,1532,766,766,514,265,249,0,0,0
33,15,0004,00903800,0,0,VILLAGE,Kovathakudi,Rural,2933,1463,1470,1263,603,660,0,0,0
33,15,0004,00903900,0,0,VILLAGE,Alagiyamanavalam,Rural,3749,1825,1924,878,429,449,0,0,0
33,15,0004,00904000,0,0,VILLAGE,Vengangudi,Rural,1267,611,656,665,329,336,0,0,0
33,15,0004,00904100,0,0,VILLAGE,Koothur,Rural,3996,1993,2003,1024,502,522,0,0,0
33,15,0004,00904200,0,0,VILLAGE,Madavarperumalkovil,Rural,3602,1762,1840,1474,705,769,0,0,0
33,15,0004,00904300,0,0,VILLAGE,Pichandarkovil,Rural,10164,5109,5055,2014,981,1033,79,40,39
33,15,0004,41509000,0,0,TOWN,S. Kannanur (TP),Urban,11782,5847,5935,1942,974,968,4,1,3
33,15,0004,41509000,1,0,WARD,S. Kannanur (TP) - Ward No.1,Urban,588,267,321,12,8,4,4,1,3
33,15,0004,41509000,2,0,WARD,S. Kannanur (TP) - Ward No.2,Urban,289,145,144,0,0,0,0,0,0
33,15,0004,41509000,3,0,WARD,S. Kannanur (TP) - Ward No.3,Urban,1499,736,763,159,86,73,0,0,0
33,15,0004,41509000,4,0,WARD,S. Kannanur (TP) - Ward No.4,Urban,1565,794,771,129,64,65,0,0,0
33,15,0004,41509000,5,0,WARD,S. Kannanur (TP) - Ward No.5,Urban,1038,530,508,51,30,21,0,0,0
33,15,0004,41509000,6,0,WARD,S. Kannanur (TP) - Ward No.6,Urban,846,409,437,101,49,52,0,0,0
33,15,0004,41509000,7,0,WARD,S. Kannanur (TP) - Ward No.7,Urban,651,319,332,474,229,245,0,0,0
33,15,0004,41509000,8,0,WARD,S. Kannanur (TP) - Ward No.8,Urban,749,370,379,123,66,57,0,0,0
33,15,0004,41509000,9,0,WARD,S. Kannanur (TP) - Ward No.9,Urban,682,330,352,168,75,93,0,0,0
33,15,0004,41509000,10,0,WARD,S. Kannanur (TP) - Ward No.10,Urban,463,226,237,453,220,233,0,0,0
33,15,0004,41509000,11,0,WARD,S. Kannanur (TP) - Ward No.11,Urban,478,249,229,73,37,36,0,0,0
33,15,0004,41509000,12,0,WARD,S. Kannanur (TP) - Ward No.12,Urban,747,362,385,17,6,11,0,0,0
33,15,0004,41509000,13,0,WARD,S. Kannanur (TP) - Ward No.13,Urban,739,369,370,0,0,0,0,0,0
33,15,0004,41509000,14,0,WARD,S. Kannanur (TP) - Ward No.14,Urban,767,392,375,179,103,76,0,0,0
33,15,0004,41509000,15,0,WARD,S. Kannanur (TP) - Ward No.15,Urban,681,349,332,3,1,2,0,0,0
33,15,0004,41510000,0,0,TOWN,Manachanallur (TP),Urban,21511,10607,10904,3596,1719,1877,15,6,9
33,15,0004,41510000,1,0,WARD,Manachanallur (TP) - Ward No.1,Urban,1077,539,538,294,147,147,0,0,0
33,15,0004,41510000,2,0,WARD,Manachanallur (TP) - Ward No.2,Urban,745,382,363,7,4,3,1,0,1
33,15,0004,41510000,3,0,WARD,Manachanallur (TP) - Ward No.3,Urban,1182,528,654,34,10,24,0,0,0
33,15,0004,41510000,4,0,WARD,Manachanallur (TP) - Ward No.4,Urban,422,210,212,0,0,0,0,0,0
33,15,0004,41510000,5,0,WARD,Manachanallur (TP) - Ward No.5,Urban,1078,520,558,576,276,300,0,0,0
33,15,0004,41510000,6,0,WARD,Manachanallur (TP) - Ward No.6,Urban,1589,777,812,32,17,15,0,0,0
33,15,0004,41510000,7,0,WARD,Manachanallur (TP) - Ward No.7,Urban,255,130,125,0,0,0,0,0,0
33,15,0004,41510000,8,0,WARD,Manachanallur (TP) - Ward No.8,Urban,911,476,435,0,0,0,0,0,0
33,15,0004,41510000,9,0,WARD,Manachanallur (TP) - Ward No.9,Urban,935,484,451,0,0,0,0,0,0
33,15,0004,41510000,10,0,WARD,Manachanallur (TP) - Ward No.10,Urban,1475,711,764,94,45,49,3,1,2
33,15,0004,41510000,11,0,WARD,Manachanallur (TP) - Ward No.11,Urban,2821,1364,1457,160,45,115,0,0,0
33,15,0004,41510000,12,0,WARD,Manachanallur (TP) - Ward No.12,Urban,2716,1351,1365,417,213,204,11,5,6
33,15,0004,41510000,13,0,WARD,Manachanallur (TP) - Ward No.13,Urban,1205,603,602,358,179,179,0,0,0
33,15,0004,41510000,14,0,WARD,Manachanallur (TP) - Ward No.14,Urban,1016,489,527,998,482,516,0,0,0
33,15,0004,41510000,15,0,WARD,Manachanallur (TP) - Ward No.15,Urban,1217,610,607,54,31,23,0,0,0
33,15,0004,41510000,16,0,WARD,Manachanallur (TP) - Ward No.16,Urban,610,313,297,0,0,0,0,0,0
33,15,0004,41510000,17,0,WARD,Manachanallur (TP) - Ward No.17,Urban,1313,641,672,257,115,142,0,0,0
33,15,0004,41510000,18,0,WARD,Manachanallur (TP) - Ward No.18,Urban,944,479,465,315,155,160,0,0,0
33,15,0005,00000000,0,0,TALUK,Lalgudi,Total,245698,121753,123945,50337,24729,25608,397,197,200
33,15,0005,00000000,0,0,TALUK,Lalgudi,Rural,190681,94552,96129,42500,20928,21572,328,164,164
33,15,0005,00000000,0,0,TALUK,Lalgudi,Urban,55017,27201,27816,7837,3801,4036,69,33,36
33,15,0005,00904400,0,0,VILLAGE,Neikulam ,Rural,2457,1233,1224,616,315,301,0,0,0
33,15,0005,00904500,0,0,VILLAGE,Oottathur,Rural,2635,1344,1291,5,2,3,0,0,0
33,15,0005,00904600,0,0,VILLAGE,Thiranipalayam,Rural,2793,1391,1402,754,396,358,0,0,0
33,15,0005,00904700,0,0,VILLAGE,Garudamangalam (North),Rural,1046,529,517,425,223,202,0,0,0
33,15,0005,00904800,0,0,VILLAGE,Garudamangalam (South),Rural,1818,950,868,601,331,270,0,0,0
33,15,0005,00904900,0,0,VILLAGE,Saradamangalam,Rural,1336,674,662,446,219,227,0,0,0
33,15,0005,00905000,0,0,VILLAGE,M. Kannanoor,Rural,1545,782,763,359,175,184,0,0,0
33,15,0005,00905100,0,0,VILLAGE,Orathur,Rural,1956,992,964,523,258,265,0,0,0
33,15,0005,00905200,0,0,VILLAGE,Sadurbagam,Rural,852,445,407,612,317,295,0,0,0
33,15,0005,00905300,0,0,VILLAGE,Malvoy,Rural,1907,963,944,0,0,0,0,0,0
33,15,0005,00905400,0,0,VILLAGE,Sirukalapur,Rural,1814,919,895,587,300,287,0,0,0
33,15,0005,00905500,0,0,VILLAGE,Nambukurichi,Rural,920,447,473,608,304,304,0,0,0
33,15,0005,00905600,0,0,VILLAGE,Periyakurukkai ,Rural,1971,999,972,603,307,296,0,0,0
33,15,0005,00905700,0,0,VILLAGE,Reddimangudi  ,Rural,2688,1327,1361,433,221,212,0,0,0
33,15,0005,00905800,0,0,VILLAGE,Peruvalappur,Rural,3413,1664,1749,540,256,284,0,0,0
33,15,0005,00905900,0,0,VILLAGE,Kanakiliyanallur,Rural,2665,1318,1347,280,141,139,0,0,0
33,15,0005,00906000,0,0,VILLAGE,Varaguppai,Rural,1129,567,562,183,92,91,0,0,0
33,15,0005,00906100,0,0,VILLAGE,Melarasoor,Rural,2400,1185,1215,580,277,303,0,0,0
33,15,0005,00906200,0,0,VILLAGE,Keelarasoor,Rural,2289,1131,1158,801,396,405,2,2,0
33,15,0005,00906300,0,0,VILLAGE,Kallagam,Rural,2792,1379,1413,641,326,315,4,2,2
33,15,0005,00906400,0,0,VILLAGE,Muthuvathur,Rural,1530,774,756,152,75,77,17,7,10
33,15,0005,00906500,0,0,VILLAGE,Thoppai,Rural,1537,774,763,110,60,50,0,0,0
33,15,0005,00906600,0,0,VILLAGE,Vandalaikudalur,Rural,2937,1450,1487,215,103,112,0,0,0
33,15,0005,00906700,0,0,VILLAGE,Kannakudi  ,Rural,2470,1263,1207,899,458,441,0,0,0
33,15,0005,00906800,0,0,VILLAGE,Thachankurichi ,Rural,2999,1460,1539,636,319,317,0,0,0
33,15,0005,00906900,0,0,VILLAGE,Mahilambadi  ,Rural,2234,1127,1107,132,67,65,0,0,0
33,15,0005,00907000,0,0,VILLAGE,Puduruthamanur,Rural,3690,1814,1876,430,219,211,0,0,0
33,15,0005,00907100,0,0,VILLAGE,Kumalur,Rural,3518,1729,1789,303,152,151,0,0,0
33,15,0005,00907200,0,0,VILLAGE,Punjaisengandhi,Rural,2404,1177,1227,58,30,28,0,0,0
33,15,0005,00907400,0,0,VILLAGE,Venkatachalapuram  (South),Rural,2047,1012,1035,32,14,18,0,0,0
33,15,0005,00907500,0,0,VILLAGE,Kovandakurichi,Rural,6172,2858,3314,123,43,80,0,0,0
33,15,0005,00907600,0,0,VILLAGE,Pudurpalayam,Rural,2665,1354,1311,95,48,47,0,0,0
33,15,0005,00907700,0,0,VILLAGE,Alambakkam,Rural,3353,1620,1733,443,215,228,60,29,31
33,15,0005,00907800,0,0,VILLAGE,Alangudimahajanam,Rural,1581,783,798,348,168,180,0,0,0
33,15,0005,00907900,0,0,VILLAGE,T.Kallikudi,Rural,1991,972,1019,823,391,432,0,0,0
33,15,0005,00908000,0,0,VILLAGE,Vellanur,Rural,730,300,430,720,294,426,0,0,0
33,15,0005,00908100,0,0,VILLAGE,Nanjaisengandhi,Rural,774,389,385,39,21,18,0,0,0
33,15,0005,00908200,0,0,VILLAGE,Edangimangalam,Rural,3068,1545,1523,474,244,230,44,23,21
33,15,0005,00908300,0,0,VILLAGE,Peruvalanallur (East),Rural,4198,2068,2130,2008,996,1012,0,0,0
33,15,0005,00908400,0,0,VILLAGE,Peruvalanallur (West),Rural,332,167,165,0,0,0,0,0,0
33,15,0005,00908600,0,0,VILLAGE,Thirumangalam ,Rural,3827,1853,1974,552,257,295,0,0,0
33,15,0005,00908700,0,0,VILLAGE,Keelamarimangalam,Rural,911,473,438,104,45,59,0,0,0
33,15,0005,00908800,0,0,VILLAGE,Neikuppai (North),Rural,1693,839,854,497,240,257,0,0,0
33,15,0005,00908900,0,0,VILLAGE,Neikuppai (South),Rural,685,349,336,129,63,66,0,0,0
33,15,0005,00909000,0,0,VILLAGE,R.Valavanur,Rural,1455,706,749,417,213,204,87,39,48
33,15,0005,00909200,0,0,VILLAGE,Madakudi,Rural,3527,1764,1763,921,463,458,0,0,0
33,15,0005,00909300,0,0,VILLAGE,V.Thuraiyur,Rural,684,360,324,454,243,211,0,0,0
33,15,0005,00909400,0,0,VILLAGE,Marudhur,Rural,2291,1130,1161,1051,506,545,0,0,0
33,15,0005,00909500,0,0,VILLAGE,Keelaperungavoor,Rural,2167,1069,1098,1158,556,602,0,0,0
33,15,0005,00909600,0,0,VILLAGE,Nagar   ,Rural,2879,1435,1444,576,279,297,26,15,11
33,15,0005,00909700,0,0,VILLAGE,Sirumayangudi (West),Rural,3475,1768,1707,1135,565,570,16,9,7
33,15,0005,00909800,0,0,VILLAGE,Sirumayangudi (East),Rural,2597,1305,1292,704,353,351,0,0,0
33,15,0005,00909900,0,0,VILLAGE,Komagudi,Rural,580,276,304,26,13,13,0,0,0
33,15,0005,00910000,0,0,VILLAGE,Sembarai,Rural,2457,1195,1262,539,259,280,0,0,0
33,15,0005,00910100,0,0,VILLAGE,Nathamangudi ,Rural,2371,1196,1175,390,173,217,0,0,0
33,15,0005,00910200,0,0,VILLAGE,Viragalur ,Rural,4484,2232,2252,200,108,92,0,0,0
33,15,0005,00910300,0,0,VILLAGE,Alambadi  ,Rural,1423,691,732,349,170,179,0,0,0
33,15,0005,00910400,0,0,VILLAGE,Thinniyam,Rural,2120,1036,1084,621,302,319,0,0,0
33,15,0005,00910500,0,0,VILLAGE,Mettupatti,Rural,847,428,419,81,39,42,0,0,0
33,15,0005,00910600,0,0,VILLAGE,Jangamarajapuram ,Rural,3041,1502,1539,1089,531,558,0,0,0
33,15,0005,00910700,0,0,VILLAGE,Adikudi,Rural,3319,1607,1712,459,213,246,6,1,5
33,15,0005,00910800,0,0,VILLAGE,Manakkal (East),Rural,1303,663,640,87,46,41,0,0,0
33,15,0005,00910900,0,0,VILLAGE,Manakkal (West),Rural,3529,1779,1750,499,260,239,0,0,0
33,15,0005,00911000,0,0,VILLAGE,Angarai,Rural,4515,2274,2241,1425,700,725,7,4,3
33,15,0005,00911100,0,0,VILLAGE,Pamparamchutti,Rural,1876,907,969,540,260,280,4,2,2
33,15,0005,00911200,0,0,VILLAGE,Nerujalakudi,Rural,2813,1425,1388,1081,533,548,38,23,15
33,15,0005,00911300,0,0,VILLAGE,Valadi,Rural,3580,1738,1842,1379,669,710,0,0,0
33,15,0005,00911400,0,0,VILLAGE,Sirumarudhur,Rural,1174,584,590,381,183,198,0,0,0
33,15,0005,00911600,0,0,VILLAGE,Pudukkudi,Rural,1410,686,724,782,390,392,0,0,0
33,15,0005,00911700,0,0,VILLAGE,Keeramangalam,Rural,1263,640,623,265,128,137,3,2,1
33,15,0005,00911800,0,0,VILLAGE,Thalakudi,Rural,3456,1739,1717,661,348,313,0,0,0
33,15,0005,00911900,0,0,VILLAGE,Appadurai,Rural,2197,1106,1091,694,330,364,4,2,2
33,15,0005,00912000,0,0,VILLAGE,Therukuchattram,Rural,978,467,511,553,256,297,0,0,0
33,15,0005,00912100,0,0,VILLAGE,Esanakorai,Rural,2552,1303,1249,99,50,49,0,0,0
33,15,0005,00912200,0,0,VILLAGE,T.Valavanoor,Rural,1163,598,565,296,137,159,7,3,4
33,15,0005,00912300,0,0,VILLAGE,Thirumanamedu (West),Rural,3235,1610,1625,507,249,258,0,0,0
33,15,0005,00912400,0,0,VILLAGE,Thirumanamedu (East),Rural,2285,1152,1133,364,177,187,0,0,0
33,15,0005,00912500,0,0,VILLAGE,Sevendhinathapuram,Rural,683,309,374,140,59,81,0,0,0
33,15,0005,00912600,0,0,VILLAGE,Seshasamudram,Rural,828,402,426,256,115,141,0,0,0
33,15,0005,00912700,0,0,VILLAGE,Idaiyathumangalam,Rural,1558,745,813,457,219,238,0,0,0
33,15,0005,00912800,0,0,VILLAGE,Koonur,Rural,2449,1228,1221,355,182,173,0,0,0
33,15,0005,00912900,0,0,VILLAGE,Sathamangalam,Rural,2962,1462,1500,545,258,287,0,0,0
33,15,0005,00913000,0,0,VILLAGE,Mangammalpuram,Rural,2494,1222,1272,660,321,339,0,0,0
33,15,0005,00913100,0,0,VILLAGE,Keelanbil,Rural,1538,765,773,649,314,335,0,0,0
33,15,0005,00913200,0,0,VILLAGE,Ariyur,Rural,3351,1659,1692,736,380,356,3,1,2
33,15,0005,41511000,0,0,TOWN,Kallakudi (TP),Urban,11491,5740,5751,1118,546,572,8,4,4
33,15,0005,41511000,1,0,WARD,Kallakudi (TP) - Ward No.1,Urban,808,417,391,19,12,7,8,4,4
33,15,0005,41511000,2,0,WARD,Kallakudi (TP) - Ward No.2,Urban,925,462,463,17,8,9,0,0,0
33,15,0005,41511000,3,0,WARD,Kallakudi (TP) - Ward No.3,Urban,709,365,344,2,1,1,0,0,0
33,15,0005,41511000,4,0,WARD,Kallakudi (TP) - Ward No.4,Urban,812,413,399,176,82,94,0,0,0
33,15,0005,41511000,5,0,WARD,Kallakudi (TP) - Ward No.5,Urban,772,378,394,0,0,0,0,0,0
33,15,0005,41511000,6,0,WARD,Kallakudi (TP) - Ward No.6,Urban,255,128,127,0,0,0,0,0,0
33,15,0005,41511000,7,0,WARD,Kallakudi (TP) - Ward No.7,Urban,517,264,253,83,40,43,0,0,0
33,15,0005,41511000,8,0,WARD,Kallakudi (TP) - Ward No.8,Urban,456,234,222,118,52,66,0,0,0
33,15,0005,41511000,9,0,WARD,Kallakudi (TP) - Ward No.9,Urban,801,377,424,3,1,2,0,0,0
33,15,0005,41511000,10,0,WARD,Kallakudi (TP) - Ward No.10,Urban,291,153,138,0,0,0,0,0,0
33,15,0005,41511000,11,0,WARD,Kallakudi (TP) - Ward No.11,Urban,1441,707,734,42,21,21,0,0,0
33,15,0005,41511000,12,0,WARD,Kallakudi (TP) - Ward No.12,Urban,374,176,198,5,3,2,0,0,0
33,15,0005,41511000,13,0,WARD,Kallakudi (TP) - Ward No.13,Urban,793,402,391,28,16,12,0,0,0
33,15,0005,41511000,14,0,WARD,Kallakudi (TP) - Ward No.14,Urban,501,243,258,386,190,196,0,0,0
33,15,0005,41511000,15,0,WARD,Kallakudi (TP) - Ward No.15,Urban,2036,1021,1015,239,120,119,0,0,0
33,15,0005,41512000,0,0,TOWN,Pullampadi (TP),Urban,11215,5376,5839,689,315,374,54,25,29
33,15,0005,41512000,1,0,WARD,Pullampadi (TP) - Ward No.1,Urban,1070,525,545,204,104,100,38,19,19
33,15,0005,41512000,2,0,WARD,Pullampadi (TP) - Ward No.2,Urban,817,377,440,41,7,34,0,0,0
33,15,0005,41512000,3,0,WARD,Pullampadi (TP) - Ward No.3,Urban,489,237,252,65,32,33,5,2,3
33,15,0005,41512000,4,0,WARD,Pullampadi (TP) - Ward No.4,Urban,847,421,426,0,0,0,0,0,0
33,15,0005,41512000,5,0,WARD,Pullampadi (TP) - Ward No.5,Urban,1217,606,611,0,0,0,0,0,0
33,15,0005,41512000,6,0,WARD,Pullampadi (TP) - Ward No.6,Urban,1272,619,653,94,48,46,5,3,2
33,15,0005,41512000,7,0,WARD,Pullampadi (TP) - Ward No.7,Urban,748,306,442,10,0,10,0,0,0
33,15,0005,41512000,8,0,WARD,Pullampadi (TP) - Ward No.8,Urban,1400,669,731,199,91,108,6,1,5
33,15,0005,41512000,9,0,WARD,Pullampadi (TP) - Ward No.9,Urban,41,22,19,0,0,0,0,0,0
33,15,0005,41512000,10,0,WARD,Pullampadi (TP) - Ward No.10,Urban,524,259,265,23,9,14,0,0,0
33,15,0005,41512000,11,0,WARD,Pullampadi (TP) - Ward No.11,Urban,60,28,32,0,0,0,0,0,0
33,15,0005,41512000,12,0,WARD,Pullampadi (TP) - Ward No.12,Urban,525,257,268,23,9,14,0,0,0
33,15,0005,41512000,13,0,WARD,Pullampadi (TP) - Ward No.13,Urban,536,259,277,0,0,0,0,0,0
33,15,0005,41512000,14,0,WARD,Pullampadi (TP) - Ward No.14,Urban,966,467,499,30,15,15,0,0,0
33,15,0005,41512000,15,0,WARD,Pullampadi (TP) - Ward No.15,Urban,703,324,379,0,0,0,0,0,0
33,15,0005,41513000,0,0,TOWN,Puvalur (TP),Urban,8906,4445,4461,1984,975,1009,0,0,0
33,15,0005,41513000,1,0,WARD,Puvalur (TP) - Ward No.1,Urban,491,238,253,2,1,1,0,0,0
33,15,0005,41513000,2,0,WARD,Puvalur (TP) - Ward No.2,Urban,677,345,332,41,18,23,0,0,0
33,15,0005,41513000,3,0,WARD,Puvalur (TP) - Ward No.3,Urban,506,249,257,479,233,246,0,0,0
33,15,0005,41513000,4,0,WARD,Puvalur (TP) - Ward No.4,Urban,420,206,214,378,191,187,0,0,0
33,15,0005,41513000,5,0,WARD,Puvalur (TP) - Ward No.5,Urban,773,375,398,2,1,1,0,0,0
33,15,0005,41513000,6,0,WARD,Puvalur (TP) - Ward No.6,Urban,577,289,288,0,0,0,0,0,0
33,15,0005,41513000,7,0,WARD,Puvalur (TP) - Ward No.7,Urban,618,312,306,0,0,0,0,0,0
33,15,0005,41513000,8,0,WARD,Puvalur (TP) - Ward No.8,Urban,515,261,254,0,0,0,0,0,0
33,15,0005,41513000,9,0,WARD,Puvalur (TP) - Ward No.9,Urban,867,447,420,89,44,45,0,0,0
33,15,0005,41513000,10,0,WARD,Puvalur (TP) - Ward No.10,Urban,528,268,260,484,240,244,0,0,0
33,15,0005,41513000,11,0,WARD,Puvalur (TP) - Ward No.11,Urban,532,266,266,489,240,249,0,0,0
33,15,0005,41513000,12,0,WARD,Puvalur (TP) - Ward No.12,Urban,665,321,344,0,0,0,0,0,0
33,15,0005,41513000,13,0,WARD,Puvalur (TP) - Ward No.13,Urban,568,294,274,0,0,0,0,0,0
33,15,0005,41513000,14,0,WARD,Puvalur (TP) - Ward No.14,Urban,549,272,277,20,7,13,0,0,0
33,15,0005,41513000,15,0,WARD,Puvalur (TP) - Ward No.15,Urban,620,302,318,0,0,0,0,0,0
33,15,0005,41514000,0,0,TOWN,Lalgudi (TP),Urban,23405,11640,11765,4046,1965,2081,7,4,3
33,15,0005,41514000,1,0,WARD,Lalgudi (TP) - Ward No.1,Urban,1468,718,750,491,241,250,0,0,0
33,15,0005,41514000,2,0,WARD,Lalgudi (TP) - Ward No.2,Urban,2368,1171,1197,148,67,81,0,0,0
33,15,0005,41514000,3,0,WARD,Lalgudi (TP) - Ward No.3,Urban,2154,1062,1092,97,47,50,0,0,0
33,15,0005,41514000,4,0,WARD,Lalgudi (TP) - Ward No.4,Urban,502,251,251,12,6,6,0,0,0
33,15,0005,41514000,5,0,WARD,Lalgudi (TP) - Ward No.5,Urban,1772,856,916,127,55,72,0,0,0
33,15,0005,41514000,6,0,WARD,Lalgudi (TP) - Ward No.6,Urban,832,424,408,261,131,130,0,0,0
33,15,0005,41514000,7,0,WARD,Lalgudi (TP) - Ward No.7,Urban,2374,1173,1201,510,239,271,0,0,0
33,15,0005,41514000,8,0,WARD,Lalgudi (TP) - Ward No.8,Urban,1273,613,660,327,144,183,0,0,0
33,15,0005,41514000,9,0,WARD,Lalgudi (TP) - Ward No.9,Urban,1274,647,627,169,92,77,0,0,0
33,15,0005,41514000,10,0,WARD,Lalgudi (TP) - Ward No.10,Urban,491,240,251,223,108,115,0,0,0
33,15,0005,41514000,11,0,WARD,Lalgudi (TP) - Ward No.11,Urban,1208,587,621,625,309,316,0,0,0
33,15,0005,41514000,12,0,WARD,Lalgudi (TP) - Ward No.12,Urban,498,260,238,0,0,0,0,0,0
33,15,0005,41514000,13,0,WARD,Lalgudi (TP) - Ward No.13,Urban,2065,1067,998,306,165,141,0,0,0
33,15,0005,41514000,14,0,WARD,Lalgudi (TP) - Ward No.14,Urban,1303,637,666,64,30,34,7,4,3
33,15,0005,41514000,15,0,WARD,Lalgudi (TP) - Ward No.15,Urban,1443,725,718,88,36,52,0,0,0
33,15,0005,41514000,16,0,WARD,Lalgudi (TP) - Ward No.16,Urban,856,445,411,0,0,0,0,0,0
33,15,0005,41514000,17,0,WARD,Lalgudi (TP) - Ward No.17,Urban,930,471,459,4,2,2,0,0,0
33,15,0005,41514000,18,0,WARD,Lalgudi (TP) - Ward No.18,Urban,594,293,301,594,293,301,0,0,0
33,15,0006,00000000,0,0,TALUK,Srirangam,Total,174689,87383,87306,38299,18806,19493,399,203,196
33,15,0006,00000000,0,0,TALUK,Srirangam,Rural,164695,82338,82357,36412,17877,18535,384,196,188
33,15,0006,00000000,0,0,TALUK,Srirangam,Urban,9994,5045,4949,1887,929,958,15,7,8
33,15,0006,00913300,0,0,VILLAGE,Pettavathalai ,Rural,8766,4364,4402,1402,692,710,2,1,1
33,15,0006,00913400,0,0,VILLAGE,Perugamani,Rural,3618,1822,1796,638,328,310,6,3,3
33,15,0006,00913500,0,0,VILLAGE,Tirupparaithurai ,Rural,4572,2713,1859,1390,686,704,3,3,0
33,15,0006,00913600,0,0,VILLAGE,Andanallur ,Rural,4540,2230,2310,1194,588,606,2,1,1
33,15,0006,00913700,0,0,VILLAGE,Kodiyalam,Rural,4099,2051,2048,1576,784,792,0,0,0
33,15,0006,00913800,0,0,VILLAGE,Kulumani,Rural,4586,2282,2304,1785,892,893,0,0,0
33,15,0006,00913900,0,0,VILLAGE,Periakaruppur,Rural,1333,682,651,426,213,213,0,0,0
33,15,0006,00914000,0,0,VILLAGE,Tiruchendurai,Rural,2469,1212,1257,370,175,195,6,2,4
33,15,0006,00914100,0,0,VILLAGE,Kadiyakurichy,Rural,902,451,451,428,215,213,0,0,0
33,15,0006,00914200,0,0,VILLAGE,Mekkudy,Rural,1529,761,768,570,279,291,0,0,0
33,15,0006,00914300,0,0,VILLAGE,Allur,Rural,3148,1563,1585,1147,566,581,0,0,0
33,15,0006,00914400,0,0,VILLAGE,Palur,Rural,1406,695,711,907,443,464,0,0,0
33,15,0006,00914500,0,0,VILLAGE,Mutharasanallur,Rural,4827,2412,2415,1243,614,629,0,0,0
33,15,0006,00914600,0,0,VILLAGE,Kambarasampettai,Rural,3923,1974,1949,1809,885,924,3,2,1
33,15,0006,00914700,0,0,VILLAGE,Paneyapuram,Rural,1235,614,621,446,221,225,0,0,0
33,15,0006,00914800,0,0,VILLAGE,Uthamsevi,Rural,2009,993,1016,438,211,227,0,0,0
33,15,0006,00914900,0,0,VILLAGE,Kilikoodu,Rural,991,504,487,171,88,83,0,0,0
33,15,0006,00915000,0,0,VILLAGE,Malliampathu,Rural,3787,1868,1919,2087,1002,1085,0,0,0
33,15,0006,00915100,0,0,VILLAGE,Somarasampettai,Rural,6270,3167,3103,1301,662,639,28,14,14
33,15,0006,00915200,0,0,VILLAGE,Kumaravayalur,Rural,1897,911,986,806,370,436,0,0,0
33,15,0006,00915300,0,0,VILLAGE,Marudankakurichi,Rural,3079,1572,1507,1212,613,599,0,0,0
33,15,0006,00915400,0,0,VILLAGE,Perur,Rural,1049,528,521,526,254,272,0,0,0
33,15,0006,00915500,0,0,VILLAGE,Mullikarumbur,Rural,1442,704,738,452,212,240,0,0,0
33,15,0006,00915600,0,0,VILLAGE,Koppu North ,Rural,6949,3402,3547,490,252,238,0,0,0
33,15,0006,00915700,0,0,VILLAGE,Koppu South ,Rural,4164,2060,2104,274,127,147,23,8,15
33,15,0006,00915800,0,0,VILLAGE,Podavur,Rural,2594,1301,1293,161,80,81,0,0,0
33,15,0006,00915900,0,0,VILLAGE,Puliyur,Rural,2965,1475,1490,120,55,65,0,0,0
33,15,0006,00916000,0,0,VILLAGE,Adavathur (West),Rural,8748,4261,4487,450,222,228,0,0,0
33,15,0006,00916100,0,0,VILLAGE,Adavathur (East),Rural,4682,2339,2343,200,99,101,0,0,0
33,15,0006,00916200,0,0,VILLAGE,Nachikurichy,Rural,4145,2097,2048,831,410,421,0,0,0
33,15,0006,00916300,0,0,VILLAGE,Sholanganallur,Rural,2922,1505,1417,416,210,206,3,2,1
33,15,0006,00916400,0,0,VILLAGE,K.Kallikudy North,Rural,3749,1887,1862,721,355,366,0,0,0
33,15,0006,00916500,0,0,VILLAGE,K.Kallikudy South,Rural,3619,1801,1818,1220,601,619,4,1,3
33,15,0006,00916600,0,0,VILLAGE,Thayanur ,Rural,8402,4140,4262,1155,544,611,0,0,0
33,15,0006,00916700,0,0,VILLAGE,Navalurkottapattu,Rural,4943,2481,2462,684,334,350,0,0,0
33,15,0006,00916800,0,0,VILLAGE,Ariyavoor-Ukkadaiariyavoor,Rural,2724,1354,1370,401,195,206,0,0,0
33,15,0006,00916900,0,0,VILLAGE,Periyanayakichatram,Rural,972,481,491,140,69,71,0,0,0
33,15,0006,00917000,0,0,VILLAGE,Ammapettai,Rural,3232,1650,1582,501,245,256,0,0,0
33,15,0006,00917100,0,0,VILLAGE,Kulathur,Rural,9300,4567,4733,1583,775,808,10,5,5
33,15,0006,00917200,0,0,VILLAGE,Mathur,Rural,1560,778,782,201,90,111,0,0,0
33,15,0006,00917300,0,0,VILLAGE,Sethurapatti,Rural,2501,1256,1245,877,431,446,10,6,4
33,15,0006,00917400,0,0,VILLAGE,Alundur,Rural,3234,1596,1638,1009,503,506,4,3,1
33,15,0006,00917500,0,0,VILLAGE,Paganur,Rural,1999,972,1027,544,253,291,0,0,0
33,15,0006,00917600,0,0,VILLAGE,Nagamangalam,Rural,4322,2135,2187,758,374,384,280,145,135
33,15,0006,00917700,0,0,VILLAGE,Kottapattu,Rural,460,213,247,85,37,48,0,0,0
33,15,0006,00917800,0,0,VILLAGE,Mekkudi,Rural,1225,611,614,332,165,167,0,0,0
33,15,0006,00917900,0,0,VILLAGE,Mudikandam,Rural,898,437,461,142,77,65,0,0,0
33,15,0006,00918000,0,0,VILLAGE,Kolakkattagudy,Rural,403,201,202,136,62,74,0,0,0
33,15,0006,00918100,0,0,VILLAGE,Thorakkudy,Rural,523,259,264,298,149,149,0,0,0
33,15,0006,00918200,0,0,VILLAGE,Thirumalaisamudram,Rural,919,485,434,183,85,98,0,0,0
33,15,0006,00918300,0,0,VILLAGE,Olaiyur,Rural,1064,521,543,176,85,91,0,0,0
33,15,0006,41515000,0,0,TOWN,Sirugamani (TP),Urban,9994,5045,4949,1887,929,958,15,7,8
33,15,0006,41515000,1,0,WARD,Sirugamani (TP) - Ward No.1,Urban,795,410,385,7,5,2,0,0,0
33,15,0006,41515000,2,0,WARD,Sirugamani (TP) - Ward No.2,Urban,531,272,259,288,144,144,0,0,0
33,15,0006,41515000,3,0,WARD,Sirugamani (TP) - Ward No.3,Urban,528,276,252,0,0,0,0,0,0
33,15,0006,41515000,4,0,WARD,Sirugamani (TP) - Ward No.4,Urban,699,362,337,618,318,300,0,0,0
33,15,0006,41515000,5,0,WARD,Sirugamani (TP) - Ward No.5,Urban,874,452,422,66,37,29,0,0,0
33,15,0006,41515000,6,0,WARD,Sirugamani (TP) - Ward No.6,Urban,791,389,402,247,107,140,0,0,0
33,15,0006,41515000,7,0,WARD,Sirugamani (TP) - Ward No.7,Urban,448,246,202,40,18,22,10,5,5
33,15,0006,41515000,8,0,WARD,Sirugamani (TP) - Ward No.8,Urban,634,319,315,0,0,0,0,0,0
33,15,0006,41515000,9,0,WARD,Sirugamani (TP) - Ward No.9,Urban,784,368,416,19,7,12,0,0,0
33,15,0006,41515000,10,0,WARD,Sirugamani (TP) - Ward No.10,Urban,761,391,370,65,35,30,0,0,0
33,15,0006,41515000,11,0,WARD,Sirugamani (TP) - Ward No.11,Urban,663,327,336,94,44,50,5,2,3
33,15,0006,41515000,12,0,WARD,Sirugamani (TP) - Ward No.12,Urban,564,264,300,436,213,223,0,0,0
33,15,0006,41515000,13,0,WARD,Sirugamani (TP) - Ward No.13,Urban,688,348,340,0,0,0,0,0,0
33,15,0006,41515000,14,0,WARD,Sirugamani (TP) - Ward No.14,Urban,776,403,373,1,0,1,0,0,0
33,15,0006,41515000,15,0,WARD,Sirugamani (TP) - Ward No.15,Urban,458,218,240,6,1,5,0,0,0
33,15,0007,00000000,0,0,TALUK,Tiruchirappalli,Total,928590,465502,463088,105487,52810,52677,3631,1817,1814
33,15,0007,00000000,0,0,TALUK,Tiruchirappalli,Rural,53026,26570,26456,11206,5609,5597,100,55,45
33,15,0007,00000000,0,0,TALUK,Tiruchirappalli,Urban,875564,438932,436632,94281,47201,47080,3531,1762,1769
33,15,0007,00918400,0,0,VILLAGE,Panayakurichy,Rural,2445,1244,1201,465,234,231,0,0,0
33,15,0007,00918500,0,0,VILLAGE,Kilamullakudy ,Rural,1829,920,909,295,139,156,0,0,0
33,15,0007,00918600,0,0,VILLAGE,Kuvalakkudy,Rural,4190,2058,2132,1790,875,915,1,0,1
33,15,0007,00918700,0,0,VILLAGE,Vengur ,Rural,1256,620,636,70,38,32,6,2,4
33,15,0007,00918800,0,0,VILLAGE,Natarajapuram,Rural,1142,568,574,194,100,94,0,0,0
33,15,0007,00918900,0,0,VILLAGE,Arasangudy,Rural,1206,611,595,188,97,91,0,0,0
33,15,0007,00919000,0,0,VILLAGE,Kiliyur,Rural,674,331,343,116,52,64,0,0,0
33,15,0007,00919100,0,0,VILLAGE,Pathalapattai,Rural,2740,1351,1389,877,430,447,1,0,1
33,15,0007,00919200,0,0,VILLAGE,Agaram,Rural,706,342,364,107,52,55,0,0,0
33,15,0007,00919300,0,0,VILLAGE,Ellakudy,Rural,4125,2093,2032,717,356,361,25,12,13
33,15,0007,00919400,0,0,VILLAGE,Alathur,Rural,1080,524,556,448,230,218,4,2,2
33,15,0007,00919500,0,0,VILLAGE,Kilakurichy,Rural,6536,3232,3304,1016,501,515,61,38,23
33,15,0007,00919600,0,0,VILLAGE,Kilakalkandarkottai,Rural,1472,740,732,570,294,276,0,0,0
33,15,0007,00919700,0,0,VILLAGE,Sholamadevi,Rural,2293,1184,1109,641,315,326,0,0,0
33,15,0007,00919800,0,0,VILLAGE,Valavandankottai,Rural,6969,3519,3450,1149,606,543,2,1,1
33,15,0007,00919900,0,0,VILLAGE,Tirunedunkulam,Rural,1464,732,732,249,123,126,0,0,0
33,15,0007,00920000,0,0,VILLAGE,Asur,Rural,1850,933,917,605,308,297,0,0,0
33,15,0007,00920100,0,0,VILLAGE,Elandapatti,Rural,646,314,332,0,0,0,0,0,0
33,15,0007,00920200,0,0,VILLAGE,Kumbakudy ,Rural,475,243,232,60,34,26,0,0,0
33,15,0007,00920300,0,0,VILLAGE,Gundur ,Rural,6506,3311,3195,1169,582,587,0,0,0
33,15,0007,00920400,0,0,VILLAGE,Sooriyur ,Rural,2400,1188,1212,269,139,130,0,0,0
33,15,0007,00920500,0,0,VILLAGE,Kandalur,Rural,1022,512,510,211,104,107,0,0,0
33,15,0007,41516000,0,0,TOWN,Tiruchirappalli (M Corp.),Urban,752066,376125,375941,70969,35403,35566,2991,1490,1501
33,15,0007,41516000,1,0,WARD,Tiruchirappalli (M Corp.) - Ward No.1,Urban,13488,6679,6809,980,482,498,35,19,16
33,15,0007,41516000,2,0,WARD,Tiruchirappalli (M Corp.) - Ward No.2,Urban,14274,7008,7266,75,41,34,0,0,0
33,15,0007,41516000,3,0,WARD,Tiruchirappalli (M Corp.) - Ward No.3,Urban,12346,6049,6297,378,193,185,57,23,34
33,15,0007,41516000,4,0,WARD,Tiruchirappalli (M Corp.) - Ward No.4,Urban,14703,7316,7387,1223,603,620,31,13,18
33,15,0007,41516000,5,0,WARD,Tiruchirappalli (M Corp.) - Ward No.5,Urban,16078,7877,8201,207,94,113,27,12,15
33,15,0007,41516000,6,0,WARD,Tiruchirappalli (M Corp.) - Ward No.6,Urban,11936,6006,5930,1855,932,923,0,0,0
33,15,0007,41516000,7,0,WARD,Tiruchirappalli (M Corp.) - Ward No.7,Urban,11263,5539,5724,462,217,245,3,2,1
33,15,0007,41516000,8,0,WARD,Tiruchirappalli (M Corp.) - Ward No.8,Urban,12882,6432,6450,2717,1347,1370,518,245,273
33,15,0007,41516000,9,0,WARD,Tiruchirappalli (M Corp.) - Ward No.9,Urban,15375,7891,7484,1242,611,631,9,5,4
33,15,0007,41516000,10,0,WARD,Tiruchirappalli (M Corp.) - Ward No.10,Urban,12788,6366,6422,491,192,299,37,15,22
33,15,0007,41516000,11,0,WARD,Tiruchirappalli (M Corp.) - Ward No.11,Urban,8353,4205,4148,24,10,14,0,0,0
33,15,0007,41516000,12,0,WARD,Tiruchirappalli (M Corp.) - Ward No.12,Urban,11961,6051,5910,272,127,145,13,5,8
33,15,0007,41516000,13,0,WARD,Tiruchirappalli (M Corp.) - Ward No.13,Urban,6795,3540,3255,14,11,3,0,0,0
33,15,0007,41516000,14,0,WARD,Tiruchirappalli (M Corp.) - Ward No.14,Urban,10141,5116,5025,953,490,463,10,5,5
33,15,0007,41516000,15,0,WARD,Tiruchirappalli (M Corp.) - Ward No.15,Urban,14911,7453,7458,4122,2039,2083,0,0,0
33,15,0007,41516000,16,0,WARD,Tiruchirappalli (M Corp.) - Ward No.16,Urban,8090,4067,4023,49,22,27,128,71,57
33,15,0007,41516000,17,0,WARD,Tiruchirappalli (M Corp.) - Ward No.17,Urban,11887,5635,6252,215,92,123,11,6,5
33,15,0007,41516000,18,0,WARD,Tiruchirappalli (M Corp.) - Ward No.18,Urban,10518,5389,5129,10,5,5,14,8,6
33,15,0007,41516000,19,0,WARD,Tiruchirappalli (M Corp.) - Ward No.19,Urban,9140,4597,4543,629,325,304,60,27,33
33,15,0007,41516000,20,0,WARD,Tiruchirappalli (M Corp.) - Ward No.20,Urban,8651,4234,4417,1354,634,720,0,0,0
33,15,0007,41516000,21,0,WARD,Tiruchirappalli (M Corp.) - Ward No.21,Urban,9219,4677,4542,1180,590,590,0,0,0
33,15,0007,41516000,22,0,WARD,Tiruchirappalli (M Corp.) - Ward No.22,Urban,11875,5929,5946,95,47,48,8,8,0
33,15,0007,41516000,23,0,WARD,Tiruchirappalli (M Corp.) - Ward No.23,Urban,10491,5156,5335,2594,1277,1317,17,8,9
33,15,0007,41516000,24,0,WARD,Tiruchirappalli (M Corp.) - Ward No.24,Urban,7612,3800,3812,36,24,12,4,1,3
33,15,0007,41516000,25,0,WARD,Tiruchirappalli (M Corp.) - Ward No.25,Urban,9828,4911,4917,1189,600,589,66,34,32
33,15,0007,41516000,26,0,WARD,Tiruchirappalli (M Corp.) - Ward No.26,Urban,10940,5389,5551,1685,853,832,50,27,23
33,15,0007,41516000,27,0,WARD,Tiruchirappalli (M Corp.) - Ward No.27,Urban,14817,7432,7385,1061,523,538,182,97,85
33,15,0007,41516000,28,0,WARD,Tiruchirappalli (M Corp.) - Ward No.28,Urban,10911,5532,5379,396,217,179,0,0,0
33,15,0007,41516000,29,0,WARD,Tiruchirappalli (M Corp.) - Ward No.29,Urban,14197,7096,7101,1889,932,957,13,6,7
33,15,0007,41516000,30,0,WARD,Tiruchirappalli (M Corp.) - Ward No.30,Urban,13511,6716,6795,3943,1957,1986,93,47,46
33,15,0007,41516000,31,0,WARD,Tiruchirappalli (M Corp.) - Ward No.31,Urban,9385,4476,4909,373,174,199,75,36,39
33,15,0007,41516000,32,0,WARD,Tiruchirappalli (M Corp.) - Ward No.32,Urban,15741,7908,7833,2869,1455,1414,731,377,354
33,15,0007,41516000,33,0,WARD,Tiruchirappalli (M Corp.) - Ward No.33,Urban,12673,6225,6448,814,403,411,9,2,7
33,15,0007,41516000,34,0,WARD,Tiruchirappalli (M Corp.) - Ward No.34,Urban,11000,5601,5399,721,383,338,19,12,7
33,15,0007,41516000,35,0,WARD,Tiruchirappalli (M Corp.) - Ward No.35,Urban,16740,8996,7744,2433,1293,1140,16,13,3
33,15,0007,41516000,36,0,WARD,Tiruchirappalli (M Corp.) - Ward No.36,Urban,8279,3914,4365,523,271,252,44,19,25
33,15,0007,41516000,37,0,WARD,Tiruchirappalli (M Corp.) - Ward No.37,Urban,11220,5642,5578,2488,1256,1232,3,1,2
33,15,0007,41516000,38,0,WARD,Tiruchirappalli (M Corp.) - Ward No.38,Urban,19201,9403,9798,1096,552,544,43,24,19
33,15,0007,41516000,39,0,WARD,Tiruchirappalli (M Corp.) - Ward No.39,Urban,14367,7173,7194,3371,1673,1698,3,2,1
33,15,0007,41516000,40,0,WARD,Tiruchirappalli (M Corp.) - Ward No.40,Urban,17201,8666,8535,2873,1441,1432,39,18,21
33,15,0007,41516000,41,0,WARD,Tiruchirappalli (M Corp.) - Ward No.41,Urban,15170,7521,7649,874,469,405,43,22,21
33,15,0007,41516000,42,0,WARD,Tiruchirappalli (M Corp.) - Ward No.42,Urban,13012,6490,6522,1248,685,563,56,28,28
33,15,0007,41516000,43,0,WARD,Tiruchirappalli (M Corp.) - Ward No.43,Urban,12454,7010,5444,908,466,442,58,32,26
33,15,0007,41516000,44,0,WARD,Tiruchirappalli (M Corp.) - Ward No.44,Urban,12394,5896,6498,1711,718,993,128,55,73
33,15,0007,41516000,45,0,WARD,Tiruchirappalli (M Corp.) - Ward No.45,Urban,17216,9116,8100,1264,674,590,75,37,38
33,15,0007,41516000,46,0,WARD,Tiruchirappalli (M Corp.) - Ward No.46,Urban,12697,6459,6238,1510,772,738,4,1,3
33,15,0007,41516000,47,0,WARD,Tiruchirappalli (M Corp.) - Ward No.47,Urban,14398,6449,7949,1817,876,941,9,5,4
33,15,0007,41516000,48,0,WARD,Tiruchirappalli (M Corp.) - Ward No.48,Urban,10739,5401,5338,1040,509,531,17,8,9
33,15,0007,41516000,49,0,WARD,Tiruchirappalli (M Corp.) - Ward No.49,Urban,14799,7425,7374,192,93,99,0,0,0
33,15,0007,41516000,50,0,WARD,Tiruchirappalli (M Corp.) - Ward No.50,Urban,15748,7892,7856,1211,591,620,0,0,0
33,15,0007,41516000,51,0,WARD,Tiruchirappalli (M Corp.) - Ward No.51,Urban,12331,6121,6210,1210,598,612,5,4,1
33,15,0007,41516000,52,0,WARD,Tiruchirappalli (M Corp.) - Ward No.52,Urban,18234,9320,8914,944,493,451,5,3,2
33,15,0007,41516000,53,0,WARD,Tiruchirappalli (M Corp.) - Ward No.53,Urban,10882,5444,5438,1659,827,832,12,5,7
33,15,0007,41516000,54,0,WARD,Tiruchirappalli (M Corp.) - Ward No.54,Urban,10795,5311,5484,97,44,53,12,5,7
33,15,0007,41516000,55,0,WARD,Tiruchirappalli (M Corp.) - Ward No.55,Urban,13172,6572,6600,515,255,260,0,0,0
33,15,0007,41516000,56,0,WARD,Tiruchirappalli (M Corp.) - Ward No.56,Urban,11410,5613,5797,658,322,336,14,9,5
33,15,0007,41516000,57,0,WARD,Tiruchirappalli (M Corp.) - Ward No.57,Urban,16864,8217,8647,1474,725,749,25,12,13
33,15,0007,41516000,58,0,WARD,Tiruchirappalli (M Corp.) - Ward No.58,Urban,11908,6077,5831,84,44,40,92,43,49
33,15,0007,41516000,59,0,WARD,Tiruchirappalli (M Corp.) - Ward No.59,Urban,9252,4734,4518,117,58,59,8,4,4
33,15,0007,41516000,60,0,WARD,Tiruchirappalli (M Corp.) - Ward No.60,Urban,13803,6965,6838,3535,1796,1739,60,29,31
33,15,0007,41517000,0,0,TOWN,Pappankurichi (CT),Urban,20371,10216,10155,4130,2075,2055,11,6,5
33,15,0007,41517000,1,0,WARD,Pappankurichi (CT) - Ward No.1,Urban,3654,1832,1822,390,206,184,1,0,1
33,15,0007,41517000,2,0,WARD,Pappankurichi (CT) - Ward No.2,Urban,4337,2169,2168,907,441,466,0,0,0
33,15,0007,41517000,3,0,WARD,Pappankurichi (CT) - Ward No.3,Urban,5463,2686,2777,657,327,330,0,0,0
33,15,0007,41517000,4,0,WARD,Pappankurichi (CT) - Ward No.4,Urban,4494,2316,2178,1112,575,537,10,6,4
33,15,0007,41517000,5,0,WARD,Pappankurichi (CT) - Ward No.5,Urban,2423,1213,1210,1064,526,538,0,0,0
33,15,0007,41518000,0,0,TOWN,Thiruverumbur (TP),Urban,16824,8502,8322,2709,1346,1363,63,26,37
33,15,0007,41518000,1,0,WARD,Thiruverumbur (TP) - Ward No.1,Urban,596,300,296,90,50,40,0,0,0
33,15,0007,41518000,2,0,WARD,Thiruverumbur (TP) - Ward No.2,Urban,844,414,430,43,20,23,0,0,0
33,15,0007,41518000,3,0,WARD,Thiruverumbur (TP) - Ward No.3,Urban,1001,493,508,95,46,49,0,0,0
33,15,0007,41518000,4,0,WARD,Thiruverumbur (TP) - Ward No.4,Urban,474,242,232,11,4,7,0,0,0
33,15,0007,41518000,5,0,WARD,Thiruverumbur (TP) - Ward No.5,Urban,1050,543,507,71,35,36,15,5,10
33,15,0007,41518000,6,0,WARD,Thiruverumbur (TP) - Ward No.6,Urban,437,210,227,19,10,9,0,0,0
33,15,0007,41518000,7,0,WARD,Thiruverumbur (TP) - Ward No.7,Urban,329,161,168,22,10,12,4,2,2
33,15,0007,41518000,8,0,WARD,Thiruverumbur (TP) - Ward No.8,Urban,632,329,303,29,16,13,4,2,2
33,15,0007,41518000,9,0,WARD,Thiruverumbur (TP) - Ward No.9,Urban,1164,552,612,609,292,317,20,10,10
33,15,0007,41518000,10,0,WARD,Thiruverumbur (TP) - Ward No.10,Urban,684,335,349,20,10,10,0,0,0
33,15,0007,41518000,11,0,WARD,Thiruverumbur (TP) - Ward No.11,Urban,1100,575,525,46,32,14,0,0,0
33,15,0007,41518000,12,0,WARD,Thiruverumbur (TP) - Ward No.12,Urban,1213,635,578,101,52,49,0,0,0
33,15,0007,41518000,13,0,WARD,Thiruverumbur (TP) - Ward No.13,Urban,731,358,373,74,40,34,2,1,1
33,15,0007,41518000,14,0,WARD,Thiruverumbur (TP) - Ward No.14,Urban,860,440,420,418,211,207,0,0,0
33,15,0007,41518000,15,0,WARD,Thiruverumbur (TP) - Ward No.15,Urban,1700,856,844,176,88,88,16,5,11
33,15,0007,41518000,16,0,WARD,Thiruverumbur (TP) - Ward No.16,Urban,1044,538,506,192,97,95,0,0,0
33,15,0007,41518000,17,0,WARD,Thiruverumbur (TP) - Ward No.17,Urban,1215,663,552,102,54,48,0,0,0
33,15,0007,41518000,18,0,WARD,Thiruverumbur (TP) - Ward No.18,Urban,1750,858,892,591,279,312,2,1,1
33,15,0007,41519000,0,0,TOWN,Koothappar (TP),Urban,17056,8573,8483,3428,1794,1634,84,39,45
33,15,0007,41519000,1,0,WARD,Koothappar (TP) - Ward No.1,Urban,813,389,424,45,25,20,0,0,0
33,15,0007,41519000,2,0,WARD,Koothappar (TP) - Ward No.2,Urban,829,392,437,0,0,0,0,0,0
33,15,0007,41519000,3,0,WARD,Koothappar (TP) - Ward No.3,Urban,801,390,411,393,181,212,0,0,0
33,15,0007,41519000,4,0,WARD,Koothappar (TP) - Ward No.4,Urban,826,398,428,91,46,45,5,2,3
33,15,0007,41519000,5,0,WARD,Koothappar (TP) - Ward No.5,Urban,389,192,197,117,58,59,11,5,6
33,15,0007,41519000,6,0,WARD,Koothappar (TP) - Ward No.6,Urban,1564,771,793,424,205,219,8,4,4
33,15,0007,41519000,7,0,WARD,Koothappar (TP) - Ward No.7,Urban,649,327,322,222,118,104,13,6,7
33,15,0007,41519000,8,0,WARD,Koothappar (TP) - Ward No.8,Urban,593,300,293,181,93,88,5,1,4
33,15,0007,41519000,9,0,WARD,Koothappar (TP) - Ward No.9,Urban,515,255,260,99,48,51,0,0,0
33,15,0007,41519000,10,0,WARD,Koothappar (TP) - Ward No.10,Urban,668,340,328,150,82,68,3,2,1
33,15,0007,41519000,11,0,WARD,Koothappar (TP) - Ward No.11,Urban,2193,1069,1124,405,207,198,19,10,9
33,15,0007,41519000,12,0,WARD,Koothappar (TP) - Ward No.12,Urban,1199,604,595,349,176,173,0,0,0
33,15,0007,41519000,13,0,WARD,Koothappar (TP) - Ward No.13,Urban,1371,691,680,252,136,116,16,6,10
33,15,0007,41519000,14,0,WARD,Koothappar (TP) - Ward No.14,Urban,1804,981,823,270,197,73,4,3,1
33,15,0007,41519000,15,0,WARD,Koothappar (TP) - Ward No.15,Urban,373,216,157,18,7,11,0,0,0
33,15,0007,41519000,16,0,WARD,Koothappar (TP) - Ward No.16,Urban,754,379,375,70,40,30,0,0,0
33,15,0007,41519000,17,0,WARD,Koothappar (TP) - Ward No.17,Urban,855,443,412,66,30,36,0,0,0
33,15,0007,41519000,18,0,WARD,Koothappar (TP) - Ward No.18,Urban,860,436,424,276,145,131,0,0,0
33,15,0007,41520000,0,0,TOWN,Krishnasamudram (CT),Urban,9215,4624,4591,1810,912,898,14,5,9
33,15,0007,41520000,1,0,WARD,Krishnasamudram (CT) - Ward No.1,Urban,565,275,290,285,138,147,0,0,0
33,15,0007,41520000,2,0,WARD,Krishnasamudram (CT) - Ward No.2,Urban,2331,1160,1171,677,356,321,0,0,0
33,15,0007,41520000,3,0,WARD,Krishnasamudram (CT) - Ward No.3,Urban,2904,1455,1449,621,301,320,0,0,0
33,15,0007,41520000,4,0,WARD,Krishnasamudram (CT) - Ward No.4,Urban,2748,1403,1345,227,117,110,14,5,9
33,15,0007,41520000,5,0,WARD,Krishnasamudram (CT) - Ward No.5,Urban,667,331,336,0,0,0,0,0,0
33,15,0007,41521000,0,0,TOWN,Thuvakudi  (TP),Urban,35428,18510,16918,5151,2636,2515,204,105,99
33,15,0007,41521000,1,0,WARD,Thuvakudi  (TP) - Ward No.1,Urban,578,301,277,17,9,8,17,11,6
33,15,0007,41521000,2,0,WARD,Thuvakudi  (TP) - Ward No.2,Urban,622,307,315,31,13,18,0,0,0
33,15,0007,41521000,3,0,WARD,Thuvakudi  (TP) - Ward No.3,Urban,784,416,368,20,10,10,0,0,0
33,15,0007,41521000,4,0,WARD,Thuvakudi  (TP) - Ward No.4,Urban,2682,1812,870,702,391,311,0,0,0
33,15,0007,41521000,5,0,WARD,Thuvakudi  (TP) - Ward No.5,Urban,4073,2112,1961,486,250,236,24,13,11
33,15,0007,41521000,6,0,WARD,Thuvakudi  (TP) - Ward No.6,Urban,992,518,474,127,61,66,11,6,5
33,15,0007,41521000,7,0,WARD,Thuvakudi  (TP) - Ward No.7,Urban,785,388,397,136,66,70,0,0,0
33,15,0007,41521000,8,0,WARD,Thuvakudi  (TP) - Ward No.8,Urban,2040,1028,1012,172,83,89,71,38,33
33,15,0007,41521000,9,0,WARD,Thuvakudi  (TP) - Ward No.9,Urban,1872,951,921,472,236,236,22,11,11
33,15,0007,41521000,10,0,WARD,Thuvakudi  (TP) - Ward No.10,Urban,1962,973,989,335,167,168,0,0,0
33,15,0007,41521000,11,0,WARD,Thuvakudi  (TP) - Ward No.11,Urban,1624,858,766,196,103,93,0,0,0
33,15,0007,41521000,12,0,WARD,Thuvakudi  (TP) - Ward No.12,Urban,691,363,328,221,119,102,13,7,6
33,15,0007,41521000,13,0,WARD,Thuvakudi  (TP) - Ward No.13,Urban,1567,813,754,288,149,139,10,4,6
33,15,0007,41521000,14,0,WARD,Thuvakudi  (TP) - Ward No.14,Urban,625,322,303,56,29,27,0,0,0
33,15,0007,41521000,15,0,WARD,Thuvakudi  (TP) - Ward No.15,Urban,3967,2241,1726,402,219,183,2,1,1
33,15,0007,41521000,16,0,WARD,Thuvakudi  (TP) - Ward No.16,Urban,1558,751,807,255,133,122,4,1,3
33,15,0007,41521000,17,0,WARD,Thuvakudi  (TP) - Ward No.17,Urban,1011,481,530,53,23,30,0,0,0
33,15,0007,41521000,18,0,WARD,Thuvakudi  (TP) - Ward No.18,Urban,1736,852,884,483,236,247,5,3,2
33,15,0007,41521000,19,0,WARD,Thuvakudi  (TP) - Ward No.19,Urban,2543,1222,1321,215,97,118,0,0,0
33,15,0007,41521000,20,0,WARD,Thuvakudi  (TP) - Ward No.20,Urban,2177,1039,1138,192,101,91,25,10,15
33,15,0007,41521000,21,0,WARD,Thuvakudi  (TP) - Ward No.21,Urban,1539,762,777,292,141,151,0,0,0
33,15,0007,41522000,0,0,TOWN,Navalpattu (CT),Urban,15394,7771,7623,4203,2095,2108,112,64,48
33,15,0007,41522000,1,0,WARD,Navalpattu (CT) - Ward No.1,Urban,2942,1416,1526,901,424,477,0,0,0
33,15,0007,41522000,2,0,WARD,Navalpattu (CT) - Ward No.2,Urban,3121,1612,1509,1406,738,668,21,13,8
33,15,0007,41522000,3,0,WARD,Navalpattu (CT) - Ward No.3,Urban,3078,1567,1511,887,437,450,57,33,24
33,15,0007,41522000,4,0,WARD,Navalpattu (CT) - Ward No.4,Urban,4344,2192,2152,700,349,351,17,10,7
33,15,0007,41522000,5,0,WARD,Navalpattu (CT) - Ward No.5,Urban,1909,984,925,309,147,162,17,8,9
33,15,0007,41523000,0,0,TOWN,Palaganangudy (CT),Urban,9210,4611,4599,1881,940,941,52,27,25
33,15,0007,41523000,1,0,WARD,Palaganangudy (CT) - Ward No.1,Urban,3989,2048,1941,1179,602,577,15,8,7
33,15,0007,41523000,2,0,WARD,Palaganangudy (CT) - Ward No.2,Urban,1636,794,842,283,142,141,3,2,1
33,15,0007,41523000,3,0,WARD,Palaganangudy (CT) - Ward No.3,Urban,1084,519,565,88,33,55,9,5,4
33,15,0007,41523000,4,0,WARD,Palaganangudy (CT) - Ward No.4,Urban,2501,1250,1251,331,163,168,25,12,13
33,15,0008,00000000,0,0,TALUK,Manapparai,Total,331255,165140,166115,55574,27468,28106,530,267,263
33,15,0008,00000000,0,0,TALUK,Manapparai,Rural,284825,142158,142667,50205,24806,25399,383,200,183
33,15,0008,00000000,0,0,TALUK,Manapparai,Urban,46430,22982,23448,5369,2662,2707,147,67,80
33,15,0008,00920600,0,0,VILLAGE,Pudur,Rural,674,349,325,16,9,7,0,0,0
33,15,0008,00920700,0,0,VILLAGE,Vaiyamalaipalayam ,Rural,667,330,337,256,126,130,0,0,0
33,15,0008,00920800,0,0,VILLAGE,Vellalapatti,Rural,4809,2455,2354,918,454,464,0,0,0
33,15,0008,00920900,0,0,VILLAGE,Aniyappur,Rural,4465,2261,2204,1026,497,529,0,0,0
33,15,0008,00921000,0,0,VILLAGE,Veeramalai RF,Rural,1265,638,627,47,23,24,0,0,0
33,15,0008,00921100,0,0,VILLAGE,Thoppampatti,Rural,4852,2425,2427,1421,718,703,58,26,32
33,15,0008,00921200,0,0,VILLAGE,Mandipatti,Rural,2897,1413,1484,660,326,334,0,0,0
33,15,0008,00921300,0,0,VILLAGE,K.Periapatti North,Rural,3620,1762,1858,754,366,388,0,0,0
33,15,0008,00921400,0,0,VILLAGE,Edayapatti,Rural,635,318,317,12,7,5,0,0,0
33,15,0008,00921500,0,0,VILLAGE,Chettichatram,Rural,2103,1059,1044,526,266,260,84,45,39
33,15,0008,00921600,0,0,VILLAGE,Chithanatham,Rural,1418,710,708,337,171,166,0,0,0
33,15,0008,00921700,0,0,VILLAGE,K.Periapatti South,Rural,562,279,283,70,31,39,0,0,0
33,15,0008,00921800,0,0,VILLAGE,Samudram,Rural,3218,1622,1596,978,477,501,183,96,87
33,15,0008,00921900,0,0,VILLAGE,Sathirapatti,Rural,745,372,373,5,3,2,0,0,0
33,15,0008,00922000,0,0,VILLAGE,Kannudayanpatti,Rural,9681,4894,4787,1523,751,772,10,8,2
33,15,0008,00922100,0,0,VILLAGE,Kalingapatti,Rural,958,483,475,186,103,83,0,0,0
33,15,0008,00922200,0,0,VILLAGE,Madampatti,Rural,708,350,358,79,39,40,0,0,0
33,15,0008,00922300,0,0,VILLAGE,Seegampatti,Rural,3148,1553,1595,488,251,237,0,0,0
33,15,0008,00922400,0,0,VILLAGE,Usilampatti,Rural,2773,1363,1410,449,210,239,2,1,1
33,15,0008,00922500,0,0,VILLAGE,Poigaimalai RF,Rural,973,587,386,333,161,172,0,0,0
33,15,0008,00922600,0,0,VILLAGE,Vadagupatti,Rural,835,425,410,202,102,100,0,0,0
33,15,0008,00922700,0,0,VILLAGE,Vengaikurichi,Rural,4469,2316,2153,712,346,366,1,1,0
33,15,0008,00922800,0,0,VILLAGE,Amayapuram,Rural,6185,3056,3129,1407,679,728,0,0,0
33,15,0008,00922900,0,0,VILLAGE,Amayapuram RF,Rural,836,420,416,15,7,8,0,0,0
33,15,0008,00923000,0,0,VILLAGE,Nallampillai,Rural,5042,2480,2562,516,253,263,0,0,0
33,15,0008,00923100,0,0,VILLAGE,I.Kovilpatti,Rural,352,172,180,73,35,38,0,0,0
33,15,0008,00923200,0,0,VILLAGE,V.Periapatti,Rural,4069,2039,2030,444,218,226,0,0,0
33,15,0008,00923300,0,0,VILLAGE,Dhavalaveeranpatti,Rural,2813,1377,1436,354,176,178,0,0,0
33,15,0008,00923400,0,0,VILLAGE,Mohavanur (North),Rural,5827,2912,2915,1119,553,566,0,0,0
33,15,0008,00923500,0,0,VILLAGE,Mohavanur (South),Rural,2727,1376,1351,184,85,99,0,0,0
33,15,0008,00923700,0,0,VILLAGE,Sekkanam,Rural,5672,2851,2821,571,298,273,0,0,0
33,15,0008,00923800,0,0,VILLAGE,Palayankottai,Rural,5449,2682,2767,1001,471,530,0,0,0
33,15,0008,00923900,0,0,VILLAGE,I.Reddiapatti,Rural,624,304,320,63,33,30,0,0,0
33,15,0008,00924000,0,0,VILLAGE,Chettiapatti,Rural,4294,2086,2208,1071,522,549,7,4,3
33,15,0008,00924100,0,0,VILLAGE,Malayandipatti,Rural,4002,1972,2030,719,351,368,0,0,0
33,15,0008,00924200,0,0,VILLAGE,Poigaipatti,Rural,6367,3172,3195,701,348,353,0,0,0
33,15,0008,00924300,0,0,VILLAGE,Sampatti,Rural,2464,1233,1231,265,118,147,0,0,0
33,15,0008,00924400,0,0,VILLAGE,Sooliapatti,Rural,1136,548,588,113,53,60,0,0,0
33,15,0008,00924500,0,0,VILLAGE,Athampatti,Rural,638,328,310,13,6,7,0,0,0
33,15,0008,00924600,0,0,VILLAGE,F.Keelaiyur,Rural,3342,1652,1690,563,257,306,0,0,0
33,15,0008,00924700,0,0,VILLAGE,Thottiapatti ,Rural,4170,2093,2077,463,230,233,0,0,0
33,15,0008,00924800,0,0,VILLAGE,Thathanur ,Rural,2144,1039,1105,204,102,102,3,1,2
33,15,0008,00924900,0,0,VILLAGE,Amanakkampatti ,Rural,2154,1049,1105,305,145,160,0,0,0
33,15,0008,00925000,0,0,VILLAGE,Kannivadugampatti,Rural,2192,1118,1074,419,207,212,0,0,0
33,15,0008,00925100,0,0,VILLAGE,Pannapatti (East),Rural,7053,3549,3504,1315,683,632,0,0,0
33,15,0008,00925200,0,0,VILLAGE,Pannapatti (West),Rural,4325,2176,2149,640,314,326,0,0,0
33,15,0008,00925300,0,0,VILLAGE,Ayanreddiapatti,Rural,4758,2355,2403,1140,567,573,0,0,0
33,15,0008,00925400,0,0,VILLAGE,Vaiyampatti,Rural,7761,3852,3909,1450,720,730,0,0,0
33,15,0008,00925500,0,0,VILLAGE,Mookureddiapatti,Rural,117,58,59,0,0,0,0,0,0
33,15,0008,00925600,0,0,VILLAGE,Kumaravadi,Rural,8133,4118,4015,956,487,469,0,0,0
33,15,0008,00925800,0,0,VILLAGE,Nadupatti,Rural,4556,2261,2295,444,220,224,0,0,0
33,15,0008,00926000,0,0,VILLAGE,Puduvadi ,Rural,1686,844,842,32,17,15,0,0,0
33,15,0008,00926300,0,0,VILLAGE,Pudukottai,Rural,3342,1662,1680,262,129,133,0,0,0
33,15,0008,00926400,0,0,VILLAGE,Ponnambalapatti,Rural,947,477,470,208,100,108,0,0,0
33,15,0008,00926600,0,0,VILLAGE,Elamanam,Rural,2923,1451,1472,506,248,258,0,0,0
33,15,0008,00926800,0,0,VILLAGE,Kannuthu ,Rural,1020,527,493,0,0,0,0,0,0
33,15,0008,00926900,0,0,VILLAGE,Kumarikatti Hills RF,Rural,605,295,310,165,74,91,0,0,0
33,15,0008,00927000,0,0,VILLAGE,Karuppur,Rural,6465,3204,3261,829,429,400,0,0,0
33,15,0008,00927200,0,0,VILLAGE,Puthanatham,Rural,9574,4833,4741,966,472,494,0,0,0
33,15,0008,00927400,0,0,VILLAGE,Thirunellipatti ,Rural,4137,2087,2050,1440,735,705,0,0,0
33,15,0008,00927500,0,0,VILLAGE,Vellayakonepatti ,Rural,2910,1488,1422,656,345,311,0,0,0
33,15,0008,00927600,0,0,VILLAGE,Pirampatti  North,Rural,740,358,382,225,104,121,0,0,0
33,15,0008,00927700,0,0,VILLAGE,Pirampatti  (South) ,Rural,2407,1205,1202,579,293,286,0,0,0
33,15,0008,00927800,0,0,VILLAGE,Thenur ,Rural,3151,1611,1540,429,213,216,0,0,0
33,15,0008,00927900,0,0,VILLAGE,Ayanpudupatti ,Rural,1662,804,858,385,185,200,0,0,0
33,15,0008,00928000,0,0,VILLAGE,Uthukuli,Rural,2671,1345,1326,233,112,121,0,0,0
33,15,0008,00928100,0,0,VILLAGE,Vembanur ,Rural,2591,1293,1298,1314,652,662,0,0,0
33,15,0008,00928200,0,0,VILLAGE,Kannukuli ,Rural,2439,1187,1252,630,309,321,0,0,0
33,15,0008,00928300,0,0,VILLAGE,Kavinaripatti,Rural,591,287,304,458,221,237,0,0,0
33,15,0008,00928400,0,0,VILLAGE,Puthakudi,Rural,180,81,99,92,39,53,0,0,0
33,15,0008,00928500,0,0,VILLAGE,Kappakudi,Rural,324,162,162,286,141,145,0,0,0
33,15,0008,00928600,0,0,VILLAGE,Kodumbapatti ,Rural,2423,1181,1242,950,464,486,0,0,0
33,15,0008,00928700,0,0,VILLAGE,Pallakurichi,Rural,4116,2135,1981,906,440,466,5,3,2
33,15,0008,00928800,0,0,VILLAGE,Kalingapatti East,Rural,2739,1310,1429,470,217,253,0,0,0
33,15,0008,00928900,0,0,VILLAGE,Kalingapatti West,Rural,945,432,513,132,65,67,0,0,0
33,15,0008,00929000,0,0,VILLAGE,Ayamporuvai,Rural,2541,1241,1300,219,106,113,0,0,0
33,15,0008,00929100,0,0,VILLAGE,Valanadu ,Rural,4308,2164,2144,1025,515,510,2,1,1
33,15,0008,00929200,0,0,VILLAGE,Paluvanji  East,Rural,1193,585,608,549,257,292,0,0,0
33,15,0008,00929300,0,0,VILLAGE,Paluvanji  West,Rural,1611,794,817,568,283,285,0,0,0
33,15,0008,00929400,0,0,VILLAGE,Muthalvarpatti ,Rural,3094,1525,1569,735,371,364,28,14,14
33,15,0008,00929500,0,0,VILLAGE,Karumalai ,Rural,3032,1538,1494,463,222,241,0,0,0
33,15,0008,00929600,0,0,VILLAGE,Ammachtram   ,Rural,3399,1618,1781,518,246,272,0,0,0
33,15,0008,00929700,0,0,VILLAGE,Endapuli ,Rural,1899,960,939,72,37,35,0,0,0
33,15,0008,00929800,0,0,VILLAGE,Kanjannaickanpatti ,Rural,3592,1804,1788,190,92,98,0,0,0
33,15,0008,00929900,0,0,VILLAGE,Velakurichi    ,Rural,1306,652,654,31,15,16,0,0,0
33,15,0008,00930000,0,0,VILLAGE,Venkatanayakanpatti  ,Rural,3809,1957,1852,911,473,438,0,0,0
33,15,0008,00930100,0,0,VILLAGE,Marungapuri ,Rural,3344,1657,1687,165,85,80,0,0,0
33,15,0008,00930200,0,0,VILLAGE,T.Idayapatti   ,Rural,2366,1136,1230,847,425,422,0,0,0
33,15,0008,00930300,0,0,VILLAGE,Yagapuram    ,Rural,2554,1302,1252,415,212,203,0,0,0
33,15,0008,00930400,0,0,VILLAGE,Nallur  ,Rural,1588,766,822,308,152,156,0,0,0
33,15,0008,00930500,0,0,VILLAGE,Karaipatti,Rural,2086,1056,1030,411,201,210,0,0,0
33,15,0008,00930600,0,0,VILLAGE,Sevalpatti,Rural,3038,1534,1504,338,175,163,0,0,0
33,15,0008,00930700,0,0,VILLAGE,Ikkaraikosakurichi ,Rural,2585,1275,1310,24,11,13,0,0,0
33,15,0008,00930800,0,0,VILLAGE,Akkiyampatti ,Rural,2911,1447,1464,715,359,356,0,0,0
33,15,0008,00930900,0,0,VILLAGE,Alagapuri   ,Rural,2382,1173,1209,699,336,363,0,0,0
33,15,0008,00931000,0,0,VILLAGE,Lekkanayakanpatti ,Rural,3052,1504,1548,823,407,416,0,0,0
33,15,0008,00931100,0,0,VILLAGE,Thethur   ,Rural,588,283,305,6,4,2,0,0,0
33,15,0008,00931200,0,0,VILLAGE,Sevandampatti ,Rural,3282,1636,1646,494,243,251,0,0,0
33,15,0008,41524000,0,0,TOWN,Manapparai (M),Urban,35770,17786,17984,3506,1752,1754,146,66,80
33,15,0008,41524000,1,0,WARD,Manapparai (M) - Ward No.1,Urban,1358,658,700,315,149,166,97,45,52
33,15,0008,41524000,2,0,WARD,Manapparai (M) - Ward No.2,Urban,1146,560,586,3,1,2,0,0,0
33,15,0008,41524000,3,0,WARD,Manapparai (M) - Ward No.3,Urban,1157,598,559,483,256,227,0,0,0
33,15,0008,41524000,4,0,WARD,Manapparai (M) - Ward No.4,Urban,1578,792,786,50,17,33,0,0,0
33,15,0008,41524000,5,0,WARD,Manapparai (M) - Ward No.5,Urban,1482,758,724,168,84,84,11,4,7
33,15,0008,41524000,6,0,WARD,Manapparai (M) - Ward No.6,Urban,1848,913,935,101,48,53,0,0,0
33,15,0008,41524000,7,0,WARD,Manapparai (M) - Ward No.7,Urban,1034,519,515,0,0,0,0,0,0
33,15,0008,41524000,8,0,WARD,Manapparai (M) - Ward No.8,Urban,782,389,393,9,4,5,0,0,0
33,15,0008,41524000,9,0,WARD,Manapparai (M) - Ward No.9,Urban,932,462,470,0,0,0,0,0,0
33,15,0008,41524000,10,0,WARD,Manapparai (M) - Ward No.10,Urban,1125,570,555,11,8,3,0,0,0
33,15,0008,41524000,11,0,WARD,Manapparai (M) - Ward No.11,Urban,1391,681,710,110,57,53,7,4,3
33,15,0008,41524000,12,0,WARD,Manapparai (M) - Ward No.12,Urban,1191,576,615,272,128,144,0,0,0
33,15,0008,41524000,13,0,WARD,Manapparai (M) - Ward No.13,Urban,1725,893,832,143,77,66,8,4,4
33,15,0008,41524000,14,0,WARD,Manapparai (M) - Ward No.14,Urban,1698,848,850,82,36,46,0,0,0
33,15,0008,41524000,15,0,WARD,Manapparai (M) - Ward No.15,Urban,832,415,417,5,2,3,0,0,0
33,15,0008,41524000,16,0,WARD,Manapparai (M) - Ward No.16,Urban,1307,657,650,357,181,176,0,0,0
33,15,0008,41524000,17,0,WARD,Manapparai (M) - Ward No.17,Urban,1078,517,561,315,146,169,0,0,0
33,15,0008,41524000,18,0,WARD,Manapparai (M) - Ward No.18,Urban,1926,971,955,38,18,20,0,0,0
33,15,0008,41524000,19,0,WARD,Manapparai (M) - Ward No.19,Urban,741,385,356,57,34,23,0,0,0
33,15,0008,41524000,20,0,WARD,Manapparai (M) - Ward No.20,Urban,2878,1453,1425,190,100,90,0,0,0
33,15,0008,41524000,21,0,WARD,Manapparai (M) - Ward No.21,Urban,1088,546,542,156,77,79,0,0,0
33,15,0008,41524000,22,0,WARD,Manapparai (M) - Ward No.22,Urban,1658,807,851,45,27,18,0,0,0
33,15,0008,41524000,23,0,WARD,Manapparai (M) - Ward No.23,Urban,1473,528,945,176,44,132,3,0,3
33,15,0008,41524000,24,0,WARD,Manapparai (M) - Ward No.24,Urban,1032,581,451,221,152,69,17,6,11
33,15,0008,41524000,25,0,WARD,Manapparai (M) - Ward No.25,Urban,1031,510,521,0,0,0,0,0,0
33,15,0008,41524000,26,0,WARD,Manapparai (M) - Ward No.26,Urban,1190,589,601,173,80,93,0,0,0
33,15,0008,41524000,27,0,WARD,Manapparai (M) - Ward No.27,Urban,1089,610,479,26,26,0,3,3,0
33,15,0008,41525000,0,0,TOWN,Ponnampatti (TP),Urban,10660,5196,5464,1863,910,953,1,1,0
33,15,0008,41525000,1,0,WARD,Ponnampatti (TP) - Ward No.1,Urban,659,322,337,439,212,227,0,0,0
33,15,0008,41525000,2,0,WARD,Ponnampatti (TP) - Ward No.2,Urban,556,261,295,555,261,294,0,0,0
33,15,0008,41525000,3,0,WARD,Ponnampatti (TP) - Ward No.3,Urban,1031,503,528,146,73,73,0,0,0
33,15,0008,41525000,4,0,WARD,Ponnampatti (TP) - Ward No.4,Urban,1510,729,781,53,48,5,0,0,0
33,15,0008,41525000,5,0,WARD,Ponnampatti (TP) - Ward No.5,Urban,399,208,191,91,44,47,0,0,0
33,15,0008,41525000,6,0,WARD,Ponnampatti (TP) - Ward No.6,Urban,867,431,436,96,41,55,0,0,0
33,15,0008,41525000,7,0,WARD,Ponnampatti (TP) - Ward No.7,Urban,535,268,267,0,0,0,0,0,0
33,15,0008,41525000,8,0,WARD,Ponnampatti (TP) - Ward No.8,Urban,607,298,309,0,0,0,0,0,0
33,15,0008,41525000,9,0,WARD,Ponnampatti (TP) - Ward No.9,Urban,373,176,197,9,4,5,0,0,0
33,15,0008,41525000,10,0,WARD,Ponnampatti (TP) - Ward No.10,Urban,875,425,450,43,19,24,1,1,0
33,15,0008,41525000,11,0,WARD,Ponnampatti (TP) - Ward No.11,Urban,990,480,510,21,11,10,0,0,0
33,15,0008,41525000,12,0,WARD,Ponnampatti (TP) - Ward No.12,Urban,1020,502,518,264,124,140,0,0,0
33,15,0008,41525000,13,0,WARD,Ponnampatti (TP) - Ward No.13,Urban,515,250,265,0,0,0,0,0,0
33,15,0008,41525000,14,0,WARD,Ponnampatti (TP) - Ward No.14,Urban,559,268,291,146,73,73,0,0,0
33,15,0008,41525000,15,0,WARD,Ponnampatti (TP) - Ward No.15,Urban,164,75,89,0,0,0,0,0,0